기준분기,상권구분,상권지역,서비스업종,분기매출,분기당_매출건수,주중_매출금액,주말_매출금액
4,발달상권,대림3동사거리,가구,205619535,220,205619535,0
4,발달상권,송파사거리(송파역),시계및귀금속,47289011,156,47289011,0
4,발달상권,상계백병원,가구,3509705,11,3509705,0
4,전통시장,화곡본동시장,가구,6554404,10,6554404,0
4,발달상권,강남을지병원,가구,125073744,108,125073744,0
4,발달상권,당산2동(영등포우체국),부동산중개업,6137998,235,6137998,0
4,발달상권,서촌(경복궁역),시계및귀금속,19387540,11,19387540,0
4,전통시장,창동골목시장,시계및귀금속,47804308,126,43761158,4043150
4,발달상권,내방역,가전제품,12928367,5,12928367,0
4,발달상권,독산동,가전제품,36000000,10,36000000,0
4,발달상권,구로디지털단지역,시계및귀금속,141507676,998,112423921,29083755
4,발달상권,대학로(혜화역),시계및귀금속,55734816,476,38624291,17110525
4,발달상권,목동신시가지,가구,1194000000,436,1194000000,0
4,발달상권,교대입구교차로,부동산중개업,20000000,8,20000000,0
4,발달상권,월곡역,시계및귀금속,20211937,177,19984837,227100
4,발달상권,롯데백화점(시청광장 지하쇼핑센터),시계및귀금속,8913898632,6249,5856252426,3057646206
4,전통시장,남문시장,시계및귀금속,27888379,46,26099388,1788991
4,발달상권,신정네거리역,시계및귀금속,112154005,364,100592374,11561631
4,전통시장,관악중부시장,시계및귀금속,45385576,179,32992034,12393542
4,발달상권,신정네거리역,가구,1382969118,1370,678589743,704379375
4,전통시장,은행나무시장,시계및귀금속,4292670,15,135120,4157550
4,발달상권,강변역(테크노마트),시계및귀금속,312157595,1944,252502577,59655018
4,전통시장,밤나무골시장,시계및귀금속,4506392,48,1999444,2506948
4,전통시장,회기시장,가전제품,6524062,92,6524062,0
4,발달상권,홍제역,가구,69576839,224,28978875,40597964
4,전통시장,화곡본동시장,시계및귀금속,42382304,146,42382304,0
4,전통시장,송화벽화시장(송화골목시장),시계및귀금속,24175674,136,23954763,220911
4,전통시장,목사랑시장(목4동시장),시계및귀금속,15576215,246,15506052,70163
4,전통시장,고덕 골목형상점가,시계및귀금속,8926698,123,4102558,4824140
4,발달상권,서울남부지방법원,가전제품,651268770,743,440025867,211242903
4,골목상권,신성초등학교,가구,14645178,88,3740544,10904634
4,골목상권,외대앞역 1번,가구,7484019,9,7484019,0
4,골목상권,성수초등학교,가전제품,34370642,92,34370642,0
4,발달상권,목동신시가지,가전제품,4811641,28,4137875,673766
4,발달상권,광화문역,시계및귀금속,29934412,377,29934412,0
4,발달상권,신설동역,시계및귀금속,56566275,283,51805371,4760904
4,발달상권,한성대입구역,시계및귀금속,3292602,171,3292602,0
4,발달상권,종로4가,시계및귀금속,16342701474,18884,12059287323,4283414151
4,전통시장,우림골목시장,시계및귀금속,6390032,45,5656130,733902
4,골목상권,구산보건지소,가구,18976042,136,18976042,0
4,발달상권,홍제역,시계및귀금속,71860126,393,64175813,7684313
4,발달상권,중구청(퇴계로4가),가구,3749284543,6782,3562674864,186609679
4,전통시장,백학시장,시계및귀금속,2046385,10,2046385,0
4,전통시장,노룬산시장(노룬산골목시장),시계및귀금속,32877277,159,29988627,2888650
4,발달상권,충정로역,시계및귀금속,6978610,48,6978610,0
4,골목상권,신월1동주민센터,가구,11896601,40,4598686,7297915
4,발달상권,을지로4가역,시계및귀금속,7736341,88,7300491,435850
4,발달상권,종로4가,가전제품,53340326,95,53221611,118715
4,발달상권,성수역,시계및귀금속,5164586,7,0,5164586
4,전통시장,고척근린시장,시계및귀금속,9582017,37,9582017,0
4,발달상권,종각역,시계및귀금속,2302641872,10953,1808959360,493682512
4,발달상권,서울역,시계및귀금속,83269417,7351,75454255,7815162
4,골목상권,홍릉시장,시계및귀금속,217447,9,217447,0
4,발달상권,고덕역,가구,10626981,50,10626981,0
4,발달상권,한티역,시계및귀금속,6969571,8,6969571,0
4,전통시장,남부종합시장,시계및귀금속,7000000,5,7000000,0
4,발달상권,구의사거리,가구,84998697,366,71106437,13892260
4,골목상권,중암중학교,가전제품,298643,36,210807,87836
4,발달상권,상수역(홍대),가구,219254203,232,117157259,102096944
4,발달상권,화곡역,가전제품,76546526,1529,65201429,11345097
4,골목상권,노원초등학교,가전제품,16162513,14,7136694,9025819
4,발달상권,신논현역,가구,213574324,514,77195539,136378785
4,발달상권,신도림역,가구,3090744269,3077,1395079473,1695664796
4,발달상권,왕십리역(왕십리),시계및귀금속,372668053,4805,213468112,159199941
4,발달상권,뱅뱅사거리,시계및귀금속,8795940,118,8714336,81604
4,발달상권,암사역,시계및귀금속,1827644,108,1671975,155669
4,발달상권,학동역,시계및귀금속,15000000,97,11564199,3435801
4,발달상권,등촌역,시계및귀금속,12555607,50,12555607,0
4,발달상권,장안동사거리,가구,6898488,70,5369442,1529046
4,전통시장,로데오거리상점가,시계및귀금속,336432341,1252,220872455,115559886
4,발달상권,문래역(문래로데오거리),시계및귀금속,641041365,3460,567636114,73405251
4,전통시장,"동원전통종합시장(동원시장, 동원전통시장 상점가)",시계및귀금속,83155132,236,69423485,13731647
4,발달상권,화곡역,시계및귀금속,37615448,106,28777507,8837941
4,전통시장,대조시장,시계및귀금속,17773137,38,773137,17000000
4,발달상권,신사역,가구,894000000,10568,549433088,344566912
4,발달상권,문정역,가구,1738217932,480,1738217932,0
4,발달상권,포스코사거리,가전제품,3891000000,108432,3680709841,210290159
4,발달상권,서울세관,가구,95958240,19,0,95958240
4,발달상권,장지역(가든파이브),시계및귀금속,211415030,2944,36663112,174751918
4,발달상권,경찰병원역,시계및귀금속,18318400,99,12603721,5714679
4,발달상권,서울대입구역,가전제품,2182508291,6999,1515830691,666677600
4,발달상권,삼성중앙역,가구,1063964123,580,348445235,715518888
4,발달상권,서래마을카페거리(서래마을),가구,422934374,1653,232888540,190045834
4,발달상권,학동사거리,시계및귀금속,463012802,260,383415303,79597499
4,전통시장,쌍문시장(쌍문역골목시장),시계및귀금속,18954199,63,14595177,4359022
4,전통시장,아현가구거리상점가,가구,4063571700,4351,2750112309,1313459391
4,전통시장,중랑동부시장,시계및귀금속,7532991,28,3528920,4004071
4,전통시장,방천골목시장,시계및귀금속,218813908,128,217034347,1779561
4,전통시장,전곡시장,시계및귀금속,6309649,31,2878351,3431298
4,전통시장,사가정시장,시계및귀금속,24912860,116,18345242,6567618
4,전통시장,우림골목시장,가전제품,22054277,264,16905257,5149020
4,전통시장,도화동 상점가,시계및귀금속,209340025,570,180015219,29324806
4,전통시장,창동신창시장,시계및귀금속,76742172,183,19404865,57337307
4,전통시장,고척근린시장,가구,394154867,843,200059783,194095084
4,전통시장,우림골목시장,가구,81657009,346,56595681,25061328
4,전통시장,행당시장상점가,시계및귀금속,53330383,197,37766658,15563725
4,전통시장,인현시장,시계및귀금속,3989704,103,3346204,643500
4,발달상권,석촌고분역,시계및귀금속,7187088,91,4792087,2395001
4,발달상권,잠실역,시계및귀금속,1900109138,3581,1815491478,84617660
4,전통시장,신곡종합시장(신월6동 골목시장),시계및귀금속,73254504,367,57207687,16046817
4,전통시장,전농로터리시장,가구,17990379,39,11544629,6445750
4,전통시장,소공지하도상가,시계및귀금속,149234097,1931,149234097,0
4,전통시장,수일시장,시계및귀금속,87074328,209,86979154,95174
4,전통시장,"솔샘시장(미아6,7동골목시장)",시계및귀금속,113565766,506,93203993,20361773
4,전통시장,공릉동 도깨비시장,시계및귀금속,4235599,31,1429190,2806409
4,전통시장,회기시장,시계및귀금속,12866418,276,10417315,2449103
4,전통시장,장위전통시장,시계및귀금속,27868161,61,23570097,4298064
4,전통시장,서울중앙시장(신중앙시장),가구,14171216036,25790,12989602982,1181613054
4,전통시장,불광먹자골목 골목형상점가,시계및귀금속,39886692,208,37107610,2779082
4,전통시장,암사종합시장,시계및귀금속,14272120,78,12755969,1516151
4,전통시장,왕십리도선동상점가,시계및귀금속,38137180,101,35564618,2572562
4,전통시장,신영시장,시계및귀금속,38325399,283,27994079,10331320
4,전통시장,제일평화시장,시계및귀금속,152533333,320,152533333,0
4,골목상권,암사역 1번,시계및귀금속,89964006,282,78563114,11400892
4,전통시장,까치산시장,시계및귀금속,103421501,526,60045218,43376283
4,전통시장,선유도역 골목형상점가,시계및귀금속,723817581,1171,714474818,9342763
4,전통시장,영등포유통상가,가전제품,183693709,750,111018790,72674919
4,전통시장,중부시장(신중부시장),가구,7059804848,158652,6933247891,126556957
4,전통시장,"동원전통종합시장(동원시장, 동원전통시장 상점가)",가구,210334953,591,166979976,43354977
4,전통시장,방이시장,시계및귀금속,25896817,210,16882710,9014107
4,전통시장,엔터식스 강남점,시계및귀금속,2781460,6,2781460,0
4,전통시장,고척골목시장상점가(그라운드 고척),시계및귀금속,15493220,30,9498526,5994694
4,전통시장,석촌시장,시계및귀금속,123046875,148,111662947,11383928
4,전통시장,남성사계시장(남성시장),시계및귀금속,85750412,549,74149294,11601118
4,전통시장,미성동 도깨비시장 골목형상점가,시계및귀금속,17102798,67,16369821,732977
4,전통시장,관악신사시장,시계및귀금속,24280012,178,17726317,6553695
4,골목상권,신월3동주민센터,시계및귀금속,4005055,59,2635342,1369713
4,전통시장,문정동 로데오거리 상점가(문정동 로데오거리),시계및귀금속,2952900,114,2952900,0
4,전통시장,상도도깨비 골목형상점가,시계및귀금속,1951890,69,1264605,687285
4,관광특구,명동 남대문 북창동 다동 무교동 관광특구,시계및귀금속,16332953988,77525,12451241719,3881712269
4,관광특구,명동 남대문 북창동 다동 무교동 관광특구,가구,17579569,91,17579569,0
4,골목상권,면목동우체국,가전제품,29437639,721,24374291,5063348
4,골목상권,암사역 2번(서울강동초등학교),시계및귀금속,369414,14,369414,0
4,골목상권,금천금빛공원(은행나무사거리서측),가구,25498891,133,23414634,2084257
4,골목상권,창2동주민센터,시계및귀금속,7354153,18,5046968,2307185
4,골목상권,염곡동 구룡사(포이동성당),가구,73000000,35,73000000,0
4,골목상권,서강대역 1번,가전제품,289859,9,0,289859
4,골목상권,포이초등학교(개포목련어린이공원),가구,378514001,6730,127142567,251371434
4,골목상권,문성초등학교,가구,155465012,397,102742733,52722279
4,골목상권,하나고등학교,가구,2000000,28,1729730,270270
4,골목상권,인수동 우편취급국,가구,104761584,256,66504158,38257426
4,골목상권,수락산역 4번,시계및귀금속,87187,9,0,87187
4,골목상권,양지어린이공원,시계및귀금속,21143296,125,20169957,973339
4,골목상권,방학초등학교,시계및귀금속,46076760,330,45017380,1059380
4,골목상권,경춘선숲길 우측,시계및귀금속,3762802,70,3762802,0
4,골목상권,포이초등학교(개포목련어린이공원),가전제품,202607899,861,202607899,0
4,골목상권,중화역 4번,시계및귀금속,9210426,54,2524140,6686286
4,골목상권,먹골역 1번,가구,246844782,329,140375295,106469487
4,골목상권,구산역 1번,가구,169288173,248,118852728,50435445
4,골목상권,숭곡초등학교,시계및귀금속,53832632,52,53283157,549475
4,골목상권,인헌고등학교(인헌중학교),시계및귀금속,39455642,350,32601844,6853798
4,골목상권,장안중학교,시계및귀금속,42530466,97,27897116,14633350
4,골목상권,새절역 2번,시계및귀금속,10124007,30,10124007,0
4,골목상권,삼양입구사거리,가구,1729858,6,1729858,0
4,골목상권,도봉구보건소,시계및귀금속,83105026,655,81314532,1790494
4,골목상권,수유시장옆,시계및귀금속,3845488,36,3845488,0
4,골목상권,수송초등학교,가구,2561654,21,2561654,0
4,골목상권,상계역,시계및귀금속,553846,38,553846,0
4,골목상권,구산보건지소,시계및귀금속,573099,164,573099,0
4,골목상권,러스크서울병원,시계및귀금속,16550940,60,11569749,4981191
4,골목상권,중랑역 1번,가구,625933,28,625933,0
4,골목상권,망우본동주민센터,시계및귀금속,31004447,190,30549459,454988
4,골목상권,종암동주민센터,시계및귀금속,93851563,1059,55414063,38437500
4,골목상권,건대입구역 6번,시계및귀금속,15858542,116,15858542,0
4,골목상권,등촌3동주민센터,시계및귀금속,21148540,348,18704022,2444518
4,골목상권,응암정보도서관,가전제품,765683,23,765683,0
4,골목상권,경신고등학교,시계및귀금속,22461341,170,6854606,15606735
4,골목상권,홍릉시장,가전제품,2282727273,3182,2075909091,206818182
4,골목상권,염창역 2번,가전제품,40724,14,20362,20362
4,골목상권,장안1동주민센터,가전제품,189667944,631,164752347,24915597
4,골목상권,양천향교역 5번,가구,1071073629,1335,1071073629,0
4,골목상권,뜸부기어린이공원,시계및귀금속,72166,8,72166,0
4,골목상권,해방촌예술마을,가전제품,50449379,459,48845051,1604328
4,골목상권,동묘앞역 2번,시계및귀금속,10024822,28,10024822,0
4,골목상권,해오름공원,가구,58923803,474,40460660,18463143
4,골목상권,연희임광아파트,가구,138835979,116,0,138835979
4,골목상권,논현2동주민센터,가전제품,5062587,6,0,5062587
4,골목상권,방화역 3번,시계및귀금속,39982072,714,38248824,1733248
4,골목상권,명지대학교교회,시계및귀금속,148352,15,0,148352
4,골목상권,태릉시장 특화거리,가전제품,45031660,292,35183095,9848565
4,골목상권,청담초등학교,시계및귀금속,3016993308,3037,1675597792,1341395516
4,골목상권,마천역(마천초등학교),시계및귀금속,75480164,385,35554838,39925326
4,골목상권,장훈고등학교,가구,8975715,102,8975715,0
4,골목상권,대청초등학교,시계및귀금속,138158488,277,133289889,4868599
4,골목상권,대림성모병원,시계및귀금속,7458209,113,7032836,425373
4,골목상권,성수119안전센터,시계및귀금속,9961064,20,9927463,33601
4,골목상권,삼성중앙역 7번,시계및귀금속,5000000,11,5000000,0
4,골목상권,남영역 1번,가전제품,199744817,99,199744817,0
4,골목상권,오류2동버들시장,시계및귀금속,26980085,82,26850946,129139
4,골목상권,목동보건지소,시계및귀금속,7914926,211,6810518,1104408
4,골목상권,아현역 2번,시계및귀금속,1926339,45,1808504,117835
4,골목상권,자양4동주민센터,시계및귀금속,12000000,8,12000000,0
4,골목상권,성수동카페거리,가전제품,7012923,151,7012923,0
4,골목상권,독산동정훈단지,가구,10971389,30,10971389,0
4,골목상권,신정역 5번,시계및귀금속,12340624,56,12340624,0
4,골목상권,강동역 4번(강풀만화거리),가전제품,28429038,93,28429038,0
4,골목상권,금산초등학교(금천고등학교),시계및귀금속,31355482,80,29295681,2059801
4,골목상권,성자초등학교,가구,17331640,76,15746009,1585631
4,골목상권,남구로역 3번,가구,205745160,473,142773526,62971634
4,골목상권,구반포역,시계및귀금속,395785980,2013,395785980,0
4,골목상권,중앙고등학교,시계및귀금속,424063285,6327,222450247,201613038
4,골목상권,NH농협은행 상도동지점,시계및귀금속,46620811,221,38835097,7785714
4,골목상권,영등포역 2번,부동산중개업,14130841,1794,10093458,4037383
4,발달상권,독산동,가구,535147679,98,535147679,0
4,골목상권,도봉역 2번,가전제품,51000001,771,48171430,2828571
4,발달상권,양재화물트럭터미널앞,가전제품,557376338,93,557376338,0
4,골목상권,방배아이파크아파트,가구,1228824787,2443,771254034,457570753
4,골목상권,구로디지털단지역 4번,가구,32090444,116,28033032,4057412
4,골목상권,자양한강도서관,시계및귀금속,22244995,74,15057197,7187798
4,골목상권,삼전역 4번,시계및귀금속,2818266,65,2560890,257376
4,골목상권,이수역 10번,가구,1185824176,272,1185824176,0
4,발달상권,연희동,시계및귀금속,14789775,65,11555301,3234474
4,골목상권,신대방삼거리역 3번,가구,20074361,71,19721146,353215
4,발달상권,오금역,가전제품,17358782,49,17358782,0
4,골목상권,광진정말공원,가구,5752508,54,3478261,2274247
4,골목상권,신월문화체육센터,시계및귀금속,8552874,16,8552874,0
4,골목상권,벌말어린이공원,시계및귀금속,414871,40,414871,0
4,발달상권,구로디지털단지,가전제품,158354315,264,134377799,23976516
4,골목상권,신월시영아파트중문,가구,130001668,157,13788055,116213613
4,발달상권,잠실새내역(신천),시계및귀금속,167774249,1117,116968908,50805341
4,발달상권,방배역,가구,8249588,14,0,8249588
4,발달상권,미아사거리역,가전제품,546197909,7845,427750179,118447730
4,발달상권,수유역,시계및귀금속,310946253,1266,226910845,84035408
4,발달상권,본서부병원,가구,16120519,69,10234408,5886111
4,발달상권,창동역,시계및귀금속,109056453,459,105671638,3384815
4,발달상권,홍대입구역(홍대),가구,808000000,547,270412214,537587786
4,발달상권,도산공원교차로,가구,1268107264,825,623390817,644716447
4,골목상권,석촌중학교(방이육교),가전제품,390274630,6982,342280993,47993637
4,발달상권,노량진역(노량진),가구,459773672,644,216928407,242845265
4,발달상권,가로수길,시계및귀금속,290732707,1865,110242476,180490231
4,발달상권,신설동역,가전제품,37919344,147,0,37919344
4,발달상권,월드컵경기장역(월드컵경기장),시계및귀금속,93472390,1519,57516534,35955856
4,발달상권,구로전화국,시계및귀금속,77592447,426,77592447,0
4,발달상권,서울대입구역,가구,48979663,238,35251799,13727864
4,발달상권,길동역,가구,5418126,166,4977081,441045
4,발달상권,신림역(신림),시계및귀금속,99761637,1560,64383422,35378215
4,발달상권,천호역,시계및귀금속,915479417,1525,604511320,310968097
4,발달상권,인사동,가전제품,43099594,125,42891081,208513
4,발달상권,을지로4가역,가구,4433314507,4983,4238756418,194558089
4,발달상권,청담사거리(청담동명품거리),시계및귀금속,3148658348,5267,1984780646,1163877702
4,발달상권,등촌역,부동산중개업,427982,96,213991,213991
4,발달상권,합정역,시계및귀금속,147910729,475,135860288,12050441
4,발달상권,어린이대공원역,시계및귀금속,41091671,92,27497686,13593985
4,발달상권,장한평역(장한평),시계및귀금속,22718023,180,12419415,10298608
4,발달상권,신용산역(용산역),가전제품,5232417971,12962,3058457816,2173960155
4,발달상권,성북구청,가전제품,100439368,826,82671370,17767998
4,발달상권,선릉역,시계및귀금속,12122401,10,856229,11266172
4,발달상권,성신여대,가구,32814259,198,32814259,0
4,발달상권,"신촌역(신촌역, 신촌로터리)",가전제품,5230416,9,0,5230416
4,발달상권,삼각지역,부동산중개업,35933333,73,35933333,0
4,발달상권,목동신시가지,시계및귀금속,342211719,2644,174218283,167993436
4,발달상권,강변역(테크노마트),가전제품,8142092517,19381,5940690297,2201402220
4,발달상권,강변역(테크노마트),가구,1702897751,1869,799026812,903870939
4,발달상권,삼청동,가구,118396942,355,118396942,0
4,전통시장,본동인정시장(기능상실),가전제품,644828,19,644828,0
4,전통시장,영등포역지하도상점가,시계및귀금속,1436111558,2173,1210467922,225643636
4,전통시장,인헌시장(원당종합시장),시계및귀금속,6509467,72,5888950,620517
4,발달상권,아차산역,가구,193373146,776,192711123,662023
4,발달상권,사가정역,시계및귀금속,20912488,90,19215604,1696884
4,발달상권,상봉역,시계및귀금속,255367965,696,172051490,83316475
4,전통시장,장미원골목시장,시계및귀금속,40009825,298,20271263,19738562
4,발달상권,여의도역(여의도),부동산중개업,160347583,675,160347583,0
4,발달상권,삼청동,시계및귀금속,18982167,251,6444015,12538152
4,발달상권,충무로역,시계및귀금속,92570798,262,92570798,0
4,발달상권,동대문역사문화공원역,시계및귀금속,49668864,112,49613181,55683
4,발달상권,가산디지털단지,시계및귀금속,109564162,1643,84538430,25025732
4,발달상권,대림3동사거리,시계및귀금속,5820854,50,4696051,1124803
4,발달상권,교육개발원입구사거리,가전제품,146221813,3458,146221813,0
4,발달상권,사당역(사당),가구,1170000000,12252,922418498,247581502
4,발달상권,포이사거리(삼호물산),가전제품,38043771,446,38043771,0
4,발달상권,구로구청,가전제품,108000000,444,72846722,35153278
4,발달상권,남부터미널역,시계및귀금속,98788707,2278,91749273,7039434
4,발달상권,석촌고분역,가구,391507350,244,258631504,132875846
4,발달상권,코엑스,가구,8512320761,3912,5431244041,3081076720
4,발달상권,목동역 8번출구,가구,63884297,91,30826446,33057851
4,발달상권,성수역,가전제품,42000000,45,24821559,17178441
4,발달상권,가산디지털단지,가구,67900416,265,67900416,0
4,전통시장,뚝도시장,시계및귀금속,45634118,182,45634118,0
4,전통시장,난곡 골목형상점가,시계및귀금속,10745152,7,9000000,1745152
4,전통시장,남대문시장(자유상가),시계및귀금속,2765170164,64826,1961430387,803739777
4,발달상권,대치역,시계및귀금속,127266397,720,121738940,5527457
4,발달상권,여의도역(여의도),가전제품,3335486,6,3335486,0
4,발달상권,역삼역,가구,26774608,159,6355004,20419604
4,발달상권,신도림역,가전제품,1328770214,7460,970618747,358151467
4,전통시장,강북북부골목시장,시계및귀금속,10330478,42,7562768,2767710
4,발달상권,교대역(법원.검찰청),부동산중개업,160606,32,160606,0
4,발달상권,구역삼세무서,가구,458263631,258,40643856,417619775
4,전통시장,창신골목시장,시계및귀금속,8960302,46,5103970,3856332
4,발달상권,대치사거리,가구,1313508573,1785,914014743,399493830
4,전통시장,성동용답상가시장,시계및귀금속,84295271,354,52636411,31658860
4,전통시장,수유프라자,가구,60770432,233,37674864,23095568
4,발달상권,서울세관,시계및귀금속,287995392,2330,287677543,317849
4,전통시장,청량리전통시장,가전제품,42211283,428,40785914,1425369
4,전통시장,월정로시장,시계및귀금속,38864687,73,23521620,15343067
4,전통시장,동묘시장(동묘벼룩시장),가전제품,30134873,614,30134873,0
4,전통시장,비단길현대시장(현대시장),시계및귀금속,243357543,312,213119060,30238483
4,전통시장,전곡시장,가전제품,192729548,637,185566360,7163188
4,전통시장,삼양골목시장(삼양시장),시계및귀금속,2079117,12,2079117,0
4,전통시장,대림상가(청계상가),가전제품,6264218499,15184,6249794192,14424307
4,전통시장,"남부골목시장(남부화곡시장, 남부시장)",시계및귀금속,85995144,303,82293846,3701298
4,전통시장,신당 미래유산 먹거리 골목형상점가,시계및귀금속,401135,7,401135,0
4,전통시장,후암시장,시계및귀금속,20807259,71,20807259,0
4,발달상권,"총신대입구역(이수, 총신대)",가전제품,501030747,1665,370900832,130129915
4,전통시장,능동로골목시장,시계및귀금속,105799591,279,99163007,6636584
4,전통시장,목동깨비시장(목3동시장),가구,37879909,170,29722251,8157658
4,발달상권,선릉역,가구,637254848,25091,479039180,158215668
4,전통시장,신정1동 골목시장(신정제일시장),시계및귀금속,1275322,38,1243117,32205
4,전통시장,종로신진시장,시계및귀금속,6715313,168,3547712,3167601
4,전통시장,세운상가가동,가전제품,2695149344,17761,2494384361,200764983
4,발달상권,왕십리역(왕십리),가구,360000000,503,278167140,81832860
4,전통시장,중랑동부시장(중랑교종합상가),시계및귀금속,6945345,51,5933446,1011899
4,전통시장,신영시장,가구,24094240,253,19347126,4747114
4,전통시장,홍대 걷고싶은 거리,시계및귀금속,116578500,1001,74453894,42124606
4,전통시장,정릉아리랑시장,가구,78661631,100,78661631,0
4,전통시장,관악중부시장,가구,181691563,306,114941439,66750124
4,전통시장,독산동 맛나는거리상점가(독산동 맛나는거리),시계및귀금속,66074027,46,63003461,3070566
4,전통시장,화곡중앙시장,가구,28524590,35,11690405,16834185
4,전통시장,중랑동부시장,가전제품,165730106,570,130573665,35156441
4,전통시장,월정로시장,가구,5485604,91,5097673,387931
4,전통시장,신아타운,시계및귀금속,14438670,69,14189297,249373
4,전통시장,남대문시장(자유상가),가전제품,235869735,1060,218195565,17674170
4,전통시장,목동깨비시장(목3동시장),시계및귀금속,80478,10,80478,0
4,전통시장,답십리현대시장,가구,6937202,88,6937202,0
4,전통시장,마천중앙시장,가전제품,28254638,357,19261278,8993360
4,전통시장,방이시장,가구,35089774,97,15245902,19843872
4,전통시장,개봉중앙시장,시계및귀금속,26664738,85,25511697,1153041
4,전통시장,동남상가,시계및귀금속,193931095,625,175451495,18479600
4,전통시장,서원동상점가,시계및귀금속,185736900,1044,100075543,85661357
4,전통시장,사당1동먹자골목상점가(사당1동먹자골목),부동산중개업,14537321,73,0,14537321
4,전통시장,숭례문수입상가(남대문시장),시계및귀금속,732093575,608,721136824,10956751
4,전통시장,도림시장,시계및귀금속,19570954,99,19262459,308495
4,전통시장,우리시장,시계및귀금속,2505800,11,0,2505800
4,관광특구,동대문패션타운 관광특구,가전제품,32678986,587,31641997,1036989
4,관광특구,강남 마이스 관광특구,가구,8512320761,3912,5431244041,3081076720
4,전통시장,새마을시장,시계및귀금속,34367095,93,5499647,28867448
4,전통시장,대림중앙 골목형상점가,부동산중개업,14110341,470,14110341,0
4,전통시장,공덕시장,시계및귀금속,6509338,183,6234296,275042
4,전통시장,숭인시장,시계및귀금속,84404232,221,4282540,80121692
4,골목상권,먹골역 5번,가구,162156889,417,103815785,58341104
4,전통시장,남구로시장,가구,35712656,135,11845288,23867368
4,전통시장,연서시장,시계및귀금속,38767140,246,30845934,7921206
4,전통시장,영림시장,부동산중개업,712469304,6505,712469304,0
4,전통시장,도곡시장,가구,8397528,54,4424504,3973024
4,전통시장,까치산시장,가전제품,5403251,201,4312266,1090985
4,관광특구,종로?청계 관광특구,시계및귀금속,12515350585,19070,8205789452,4309561133
4,관광특구,종로?청계 관광특구,가전제품,2782015757,18313,2570842356,211173401
4,관광특구,이태원 관광특구,시계및귀금속,543945287,1069,315267355,228677932
4,골목상권,만리재,시계및귀금속,7951615,55,5163139,2788476
4,골목상권,아차산역 1번,가전제품,47227873,472,44368834,2859039
4,골목상권,시흥초등학교(시흥1동우체국),시계및귀금속,25449586,50,25449586,0
4,골목상권,광진정말공원,시계및귀금속,68290861,293,67452164,838697
4,골목상권,개봉1동주민센터,가구,98471220,287,55059178,43412042
4,골목상권,시흥초등학교(시흥1동우체국),가구,39363504,52,21261314,18102190
4,골목상권,푸른들청소년도서관,시계및귀금속,20400150,108,6473354,13926796
4,골목상권,남구로역 5번,가전제품,2882499,82,378842,2503657
4,골목상권,독산동성당,시계및귀금속,8593064,39,3957901,4635163
4,골목상권,서초소방서,가구,276000000,160,107556941,168443059
4,골목상권,영서중학교,시계및귀금속,27858494,97,27858494,0
4,골목상권,방학1동주민센터,가전제품,498362,11,498362,0
4,골목상권,수락산디자인거리,시계및귀금속,5686158,64,5608485,77673
4,골목상권,행당역 2번,시계및귀금속,86286969,142,83262477,3024492
4,골목상권,수락산역 4번,가구,9754678,8,9754678,0
4,골목상권,방학역 1번,가전제품,1917592825,9513,1642630759,274962066
4,골목상권,쌍문역1번(쌍리단길),시계및귀금속,13734463,56,12491525,1242938
4,골목상권,신창초등학교,가구,10340717,51,6363518,3977199
4,골목상권,역촌노인복지관,시계및귀금속,475305,12,475305,0
4,골목상권,길음역 8번,가구,714482,7,714482,0
4,골목상권,수락산역 4번,가전제품,117000000,379,60429891,56570109
4,골목상권,장스여성병원,가전제품,6000000,26,5446372,553628
4,골목상권,종암아이파크2차,시계및귀금속,4167759,70,2622299,1545460
4,골목상권,은평세무서,가구,58572576,218,48931749,9640827
4,골목상권,연신내역 3번,가구,349789750,916,266565922,83223828
4,골목상권,상월곡역 1번,가전제품,196189743,823,80482106,115707637
4,골목상권,시립서북병원,시계및귀금속,7168133,88,1185457,5982676
4,골목상권,남가좌파출소,시계및귀금속,18485102,131,11096319,7388783
4,골목상권,망우역 1번,가전제품,3288416308,8114,2140008155,1148408153
4,골목상권,전농1동주민센터(전농시장),가구,5272727,128,0,5272727
4,골목상권,면목역 3번,시계및귀금속,3705090,7,3705090,0
4,골목상권,신내1동주민센터,가전제품,2815954,35,2815954,0
4,골목상권,상봉역 4번,부동산중개업,6769231,21,6769231,0
4,골목상권,고려대역 4번,가구,873599,43,276995,596604
4,골목상권,영신초등학교,가전제품,224504173,932,224504173,0
4,골목상권,석촌고분역 1번,가구,111554204,55,0,111554204
4,골목상권,동교초등학교,시계및귀금속,8544296,146,4004632,4539664
4,골목상권,양천향교역 5번,가전제품,22276389,143,18102112,4174277
4,골목상권,금호삼성래미안아파트,시계및귀금속,8943282,15,1823093,7120189
4,골목상권,둔촌동역 1번(한산중학교),시계및귀금속,4654952,108,4538104,116848
4,골목상권,신월2동주민센터,가구,20000000,24,0,20000000
4,골목상권,화곡역 4번,시계및귀금속,1406294,10,0,1406294
4,골목상권,화곡2동주민센터,가구,29445225,64,14880074,14565151
4,골목상권,화원중학교,시계및귀금속,13567388,64,9606865,3960523
4,골목상권,화양사거리,시계및귀금속,18516209,153,10022605,8493604
4,골목상권,곰달래도서관,시계및귀금속,58926228,168,33658470,25267758
4,골목상권,구의역 4번,시계및귀금속,57763425,219,35819778,21943647
4,골목상권,동대부고,가전제품,503824539,1644,456718063,47106476
4,골목상권,창신역 1번,시계및귀금속,189183,22,189183,0
4,골목상권,대흥역 2번,시계및귀금속,238824293,768,154196821,84627472
4,골목상권,체부동홍종문가옥,시계및귀금속,23919206,120,23919206,0
4,골목상권,종로5가역 4번,시계및귀금속,25120643,86,25120643,0
4,골목상권,신방화역 2번,가구,51634183,63,29595203,22038980
4,골목상권,능동우편취급국,가구,75623486,124,43533257,32090229
4,골목상권,명지대학교,시계및귀금속,24934453,179,14549937,10384516
4,골목상권,장안제일시장,시계및귀금속,6744616,30,6744616,0
4,골목상권,송파나루역 2번,시계및귀금속,11075754,120,10908648,167106
4,골목상권,해방촌 남동측,시계및귀금속,33370652,60,28827174,4543478
4,골목상권,언주역 6번,가구,814636095,133,814636095,0
4,골목상권,묘곡초등학교(고덕아이파크아파트),시계및귀금속,6251959,147,6070516,181443
4,골목상권,논현2동주민센터,시계및귀금속,158820430,123,104480795,54339635
4,골목상권,신월2동주민센터,시계및귀금속,51237823,1018,43960999,7276824
4,골목상권,보라매역 2번,시계및귀금속,3266666,167,3266666,0
4,골목상권,석촌역 6번,시계및귀금속,48174193,111,48174193,0
4,골목상권,당곡중학교,시계및귀금속,13572995,90,7434961,6138034
4,골목상권,대림썬프라자,시계및귀금속,9771273,25,8162913,1608360
4,골목상권,우리은행응암동지점,시계및귀금속,43439128,570,35840062,7599066
4,골목상권,금천구청역 1번 출입구,시계및귀금속,46158218,239,41562396,4595822
4,골목상권,봉천역 6번,시계및귀금속,18000000,8,0,18000000
4,골목상권,상도역 5번,시계및귀금속,25762320,136,22648495,3113825
4,골목상권,석수역 1번 출입구,시계및귀금속,390004,8,390004,0
4,골목상권,남구로역 2번,시계및귀금속,10291267,108,8914863,1376404
4,골목상권,그라운드 고척,시계및귀금속,30202703,50,15202703,15000000
4,골목상권,난우초등학교,가구,35141521,104,26328772,8812749
4,골목상권,관악구신사동주민센터,가전제품,18425884,224,11545891,6879993
4,골목상권,문정초등학교,시계및귀금속,2036048,10,2036048,0
4,골목상권,동대문역 1번,시계및귀금속,7313560,51,5309060,2004500
4,골목상권,남구로역 2번,가구,11781155,52,11781155,0
4,골목상권,문정역 2번,시계및귀금속,34317820,164,34226936,90884
4,골목상권,신림역 8번,가구,1203904173,2835,749014940,454889233
4,골목상권,성자초등학교,시계및귀금속,297000000,522,297000000,0
4,골목상권,신정네거리역 2번,가구,34880621,100,34880621,0
4,골목상권,신풍역 6번(신길6동공영주차장),가구,46788095,202,39953315,6834780
4,골목상권,선일여고,시계및귀금속,2832755,12,2832755,0
4,골목상권,대동초등학교,가구,60544176,306,42243669,18300507
4,골목상권,사당역 10번,시계및귀금속,225462529,403,221859198,3603331
4,발달상권,가산디지털단지,부동산중개업,17506221,5,17506221,0
4,발달상권,군자역,가구,4972202469,4945,2513730440,2458472029
4,발달상권,사당역(사당),부동산중개업,62552773,3846,59027349,3525424
4,발달상권,사당역(사당),시계및귀금속,9846408,336,9568413,277995
4,발달상권,오류동역,시계및귀금속,109851169,630,83625658,26225511
4,발달상권,마들역,시계및귀금속,17579230,189,9403283,8175947
4,발달상권,구산역,시계및귀금속,63050708,258,51610147,11440561
4,골목상권,강동구립성내도서관,시계및귀금속,5047198,10,4946254,100944
4,발달상권,구파발역,시계및귀금속,664391449,652,547038721,117352728
4,발달상권,용산전자상가(용산역),가전제품,1.86E+11,527380,1.12E+11,74730468483
4,골목상권,서울지방병무청,가구,187016200,261,187016200,0
4,골목상권,신대방역 4번,시계및귀금속,25425118,56,25340217,84901
4,발달상권,종로3가역,시계및귀금속,2.32E+11,361899,1.84E+11,47809212416
4,발달상권,금호역,시계및귀금속,84395174,425,55351591,29043583
4,발달상권,장안동사거리,시계및귀금속,15441804,827,13580220,1861584
4,발달상권,양재천카페거리,가구,14091000000,81162,8686924882,5404075118
4,발달상권,연신내역,가전제품,53150027,951,39966662,13183365
4,발달상권,언주역(차병원),가구,395037931,54,342000000,53037931
4,발달상권,압구정역,시계및귀금속,2126754828,28798,991297239,1135457589
4,발달상권,미아사거리,시계및귀금속,1174946732,3090,771030695,403916037
4,발달상권,공릉역,시계및귀금속,21499739,42,14028198,7471541
4,발달상권,영등포역(영등포),가구,1352875596,3399,716112488,636763108
4,발달상권,영등포역(영등포),시계및귀금속,10775953524,79707,5973240744,4802712780
4,발달상권,한성대입구역,가구,224051792,108,203748133,20303659
4,발달상권,본서부병원,가전제품,1379822597,4016,967384645,412437952
4,발달상권,인사동,시계및귀금속,1217553380,28180,448583335,768970045
4,발달상권,서대문역,시계및귀금속,19724506,163,19666451,58055
4,발달상권,"신촌역(신촌역, 신촌로터리)",시계및귀금속,380125297,1785,371348071,8777226
4,발달상권,상봉역,가전제품,1237248484,2589,678897367,558351117
4,발달상권,성수대교남단,가구,297125793,197,183999492,113126301
4,발달상권,명동(명동거리),시계및귀금속,1845557520,3474,1836187985,9369535
4,발달상권,서촌(경복궁역),가전제품,227782536,321,227782536,0
4,발달상권,건대입구역(건대),시계및귀금속,484588141,3190,272365542,212222599
4,발달상권,홍대입구역(홍대),시계및귀금속,95879573,729,71888456,23991117
4,발달상권,용산전자상가(용산역),시계및귀금속,174000000,239,153099621,20900379
4,발달상권,상수역(홍대),부동산중개업,521293644,39574,362300692,158992952
4,발달상권,천호역,가구,325600109,1051,158276572,167323537
4,발달상권,종로3가역,가전제품,6077831,167,4562877,1514954
4,발달상권,홍대입구역(홍대),가전제품,17479616,12,17479616,0
4,발달상권,등촌역,가구,2108182897,2432,1061792325,1046390572
4,발달상권,동대문역,시계및귀금속,31295083,59,8504554,22790529
4,발달상권,장한평역(장한평),가구,15000000,38,15000000,0
4,발달상권,구의사거리,시계및귀금속,25296637,140,19911064,5385573
4,발달상권,굽은다리역,시계및귀금속,67789832,132,41846777,25943055
4,발달상권,구의역,시계및귀금속,34769231,354,33010396,1758835
4,발달상권,중림동,가전제품,18589826,26,16727672,1862154
4,발달상권,코엑스,가전제품,1364810577,4605,947592304,417218273
4,발달상권,명일역,시계및귀금속,57483982,532,53104501,4379481
4,발달상권,아차산역,가전제품,381735504,1332,294852273,86883231
4,발달상권,오목교역,시계및귀금속,1025204622,974,978805559,46399063
4,발달상권,가락시장역,가전제품,6966250,12,6966250,0
4,발달상권,신대방삼거리역,시계및귀금속,22013311,333,15990016,6023295
4,발달상권,오목교역,가구,161149280,79,161149280,0
4,발달상권,오금역,가구,176802777,101,176802777,0
4,발달상권,목동사거리,가전제품,4233848201,5676,1888643001,2345205200
4,발달상권,강남역,가구,92871247,288,92871247,0
4,발달상권,논현역,시계및귀금속,164598012,235,137243028,27354984
4,전통시장,영림시장,시계및귀금속,27334683,220,9613524,17721159
4,발달상권,학동사거리,가구,38093822,663,38093822,0
4,발달상권,신용산역(용산역),가구,5732000000,4198,2855729465,2876270535
4,전통시장,공릉동 도깨비시장,가구,21683518,102,19952908,1730610
4,전통시장,강북종합전통시장(강북종합골목시장),시계및귀금속,1837800,57,1797320,40480
4,전통시장,청량리수산시장,가구,411511432,802,353488052,58023380
4,발달상권,독산동,시계및귀금속,218354939,1300,165180938,53174001
4,전통시장,방학동도깨비시장,시계및귀금속,65941383,424,54423935,11517448
4,발달상권,석촌역(석촌호수),시계및귀금속,10609317,91,10402952,206365
4,발달상권,개봉동 현대아파트,가구,38641861,291,38641861,0
4,전통시장,영천시장,시계및귀금속,58541341,262,53488959,5052382
4,발달상권,선정릉역,가구,120294744,106,102781267,17513477
4,발달상권,남부터미널역,가전제품,2765634765,9504,2612745739,152889026
4,발달상권,보라매역,시계및귀금속,1536089,68,1479822,56267
4,골목상권,먹골역 5번,시계및귀금속,29337447,155,27728638,1608809
4,전통시장,우림시장,시계및귀금속,109923343,451,86598908,23324435
4,골목상권,서일대학교,시계및귀금속,65358737,303,43294840,22063897
4,골목상권,중화역 4번,가구,15795587,89,11514236,4281351
4,전통시장,풍납시장,시계및귀금속,40013142,175,17932014,22081128
4,골목상권,연천초등학교,시계및귀금속,3920703,93,3477290,443413
4,전통시장,대조시장,가구,5833774,67,4831244,1002530
4,전통시장,충신시장,가전제품,41917266,291,41917266,0
4,골목상권,종암경찰서,시계및귀금속,91346680,322,32978796,58367884
4,전통시장,제일시장,시계및귀금속,390099022,2184,231934240,158164782
4,골목상권,상봉역 4번,가구,176083850,230,86762245,89321605
4,전통시장,뚝섬역상점가,시계및귀금속,3560192,127,3560192,0
4,골목상권,청량초등학교,가구,55811852,160,6691644,49120208
4,골목상권,응암3동주민센터,가구,46036946,121,35172810,10864136
4,전통시장,"중곡제일시장(중곡제일골목시장, 광성시장)",시계및귀금속,69408203,218,61529635,7878568
4,전통시장,공항시장,시계및귀금속,91035111,26,91035111,0
4,골목상권,면목동우체국,시계및귀금속,1811806,18,1811806,0
4,골목상권,상신초등학교입구,시계및귀금속,116856,23,116856,0
4,전통시장,고분다리전통시장,시계및귀금속,16736732,44,16736732,0
4,전통시장,성내전통시장,시계및귀금속,6666667,77,4242425,2424242
4,골목상권,성원중학교,가구,277823948,68,260000000,17823948
4,골목상권,사근동살곶이상점가,시계및귀금속,5522613,317,5522613,0
4,골목상권,KB국민은행 망원동지점,가구,5817147,72,4524448,1292699
4,전통시장,용산용문시장,시계및귀금속,4294042,44,4294042,0
4,전통시장,관악신사시장,가구,1876503,57,0,1876503
4,전통시장,낙원시장(낙원지하시장(대일상가)),가전제품,1539168614,10543,1194426894,344741720
4,전통시장,도곡시장,시계및귀금속,570725569,590,442352477,128373092
4,관광특구,동대문패션타운 관광특구,가구,3901380835,13704,2951508628,949872207
4,골목상권,성원중학교,가전제품,280211769,403,277763828,2447941
4,관광특구,강남 마이스 관광특구,가전제품,1364810577,4605,947592304,417218273
4,골목상권,성원중학교,시계및귀금속,73437663,184,69606925,3830738
4,골목상권,푸른들청소년도서관,가구,38964209,98,18420077,20544132
4,골목상권,마포구청역 4번,가전제품,12370045921,3882,7423313969,4946731952
4,골목상권,마천역(마천초등학교),가구,99150338,367,88592440,10557898
4,골목상권,경리단길남측,시계및귀금속,15887939,273,12600779,3287160
4,골목상권,등촌1동주민센터,가구,1072565936,1048,641303165,431262771
4,골목상권,남구로역 5번,시계및귀금속,180475766,413,139642608,40833158
4,골목상권,미아사거리역 3번,가구,4710946,5,4710946,0
4,골목상권,화곡초등학교,시계및귀금속,2720247,120,1898506,821741
4,골목상권,개봉1동주민센터,가전제품,23005540,92,17002770,6002770
4,골목상권,용산구청,시계및귀금속,19542559,193,19542559,0
4,골목상권,신방화역 2번,가전제품,5021283134,3124,3048676449,1972606685
4,골목상권,모래내우체국,가전제품,10876435343,3862,6275814264,4600621079
4,골목상권,천호공원(해공체육문화센터),가구,4678230,48,4678230,0
4,골목상권,금천구립가산도서관,시계및귀금속,1336226,57,1145336,190890
4,골목상권,상계2동주민센터,가구,36290988,77,30790038,5500950
4,골목상권,도봉산입구,시계및귀금속,82217643,301,57853639,24364004
4,골목상권,신대방역 3번,부동산중개업,1425285,282,1266920,158365
4,골목상권,덕의초등학교,시계및귀금속,15237288,111,15099019,138269
4,골목상권,자양동우체국,시계및귀금속,1176100,34,1176100,0
4,골목상권,남천초등학교,시계및귀금속,13619047,30,13619047,0
4,골목상권,구로4동주민센터,시계및귀금속,1466458,24,249610,1216848
4,골목상권,방학역 1번,시계및귀금속,21582865,69,17108063,4474802
4,골목상권,구로초등학교,시계및귀금속,15372357,47,8462560,6909797
4,골목상권,계상초등학교,시계및귀금속,13025408,56,11371761,1653647
4,골목상권,푸른동산공원,시계및귀금속,39000000,49,39000000,0
4,골목상권,마천1치안센터,가전제품,38676093,165,36166261,2509832
4,골목상권,문성초등학교,시계및귀금속,17503991,75,8634558,8869433
4,골목상권,남성역 1번,시계및귀금속,8607537,80,8462691,144846
4,골목상권,봉천역 4번(봉천110안전센터),가구,134000000,538,88282353,45717647
4,골목상권,방배역 3번,가구,183846566,123,166195379,17651187
4,골목상권,광운대역 1번,시계및귀금속,62156355,179,54142788,8013567
4,골목상권,수유동우체국,가구,6856196,90,4963290,1892906
4,골목상권,용두동신동아아파트,시계및귀금속,36022768,54,35992724,30044
4,골목상권,서울여자간호대학교,시계및귀금속,114583,21,114583,0
4,골목상권,석계역 2번,시계및귀금속,13671691,152,11038625,2633066
4,골목상권,돌곶이역 5번,시계및귀금속,21630617,72,20394408,1236209
4,골목상권,공릉동 국수거리,가구,121478304,125,55837732,65640572
4,골목상권,연신내우체국,시계및귀금속,691099,13,691099,0
4,골목상권,대동초등학교,시계및귀금속,2543417,44,2514182,29235
4,골목상권,신내1동주민센터,시계및귀금속,98565654,336,72573738,25991916
4,골목상권,보문역 4번,가구,92690783,269,40471382,52219401
4,발달상권,강남을지병원,시계및귀금속,1024553428,416,82710579,941842849
4,골목상권,학동초등학교,가전제품,79296458,426,79296458,0
4,골목상권,장안근린공원,시계및귀금속,7433900,54,7433900,0
4,골목상권,자양4동주민센터,가구,6970860,72,5389840,1581020
4,골목상권,황학코아루아파트,시계및귀금속,10644394,47,10644394,0
4,골목상권,신길2동우편취급국,시계및귀금속,115103764,592,107675193,7428571
4,골목상권,공항시장역 3번,시계및귀금속,16743265,96,13624892,3118373
4,골목상권,KB국민은행 망원동지점,시계및귀금속,30730526,145,28136580,2593946
4,발달상권,서교동(홍대),시계및귀금속,9417531,169,4843301,4574230
4,골목상권,중곡역 3번,시계및귀금속,1996463,23,23215,1973248
4,골목상권,신월3동주민센터,가구,6024523,82,1610354,4414169
4,발달상권,삼호가든사거리,시계및귀금속,26890432,801,12091067,14799365
4,관광특구,잠실 관광특구,시계및귀금속,1907491461,3546,1823677803,83813658
4,골목상권,화곡역 4번,가구,76547388,1124,76547388,0
4,관광특구,명동 남대문 북창동 다동 무교동 관광특구,가전제품,488086798,2979,400687635,87399163
4,관광특구,강남 마이스 관광특구,시계및귀금속,1463361463,1487,1078494961,384866502
4,골목상권,신림현대아파트,가전제품,19664577,214,18529258,1135319
4,골목상권,화곡2동주민센터,시계및귀금속,3398150,11,3398150,0
4,골목상권,암사동성당(효정하나플러스아파트),시계및귀금속,13639534,48,11917150,1722384
4,골목상권,솔숲어린이공원,가구,2395933,12,2189387,206546
4,골목상권,신림역 8번,가전제품,4367803641,1966,2604282276,1763521365
4,골목상권,충정로역 6번,가구,2809904920,3157,2281045933,528858987
4,골목상권,장승배기역 5번,가구,18000000,33,14385960,3614040
4,골목상권,삼성산자연공원(서울금천초등학교),가구,4837005,38,4837005,0
4,골목상권,연신내역 7번,시계및귀금속,24290268,749,20835519,3454749
4,골목상권,남구로역 3번,가전제품,2579814,52,2579814,0
4,골목상권,원신초등학교(구세군관악영문교회),가전제품,68791259,373,44094307,24696952
4,골목상권,성남고등학교,시계및귀금속,2163191,7,2163191,0
4,골목상권,방학중학교,시계및귀금속,62391042,72,32421502,29969540
4,골목상권,영신초등학교,시계및귀금속,88340148,153,83456215,4883933
4,골목상권,도봉구 정병원,가전제품,462932936,307,332637242,130295694
4,골목상권,헌인가구단지,가구,192189321,465,64514970,127674351
4,골목상권,평창동서측,시계및귀금속,7667858,13,7667858,0
4,골목상권,고대앞사거리,가전제품,4545455,114,4545455,0
4,골목상권,남부초등학교,시계및귀금속,2704059,6,2619455,84604
4,골목상권,독산동정훈단지,시계및귀금속,40837812,127,29864978,10972834
4,골목상권,서초동성당,가구,858797224,260,593077697,265719527
4,골목상권,당고개역 5번,가전제품,12070176,158,10929825,1140351
4,골목상권,쌍문2동우체국,가구,27640858,315,17574386,10066472
4,골목상권,서문여고,가구,13423579,163,13423579,0
4,골목상권,거여역 1번(거여공원),가전제품,163307042,501,124664258,38642784
4,골목상권,방이역 1번,가구,4671681,19,4671681,0
4,골목상권,4.19민주묘지역 2번,시계및귀금속,35476553,233,34310519,1166034
4,골목상권,창2동주민센터,가구,96039582,42,96039582,0
4,발달상권,양재화물트럭터미널앞,시계및귀금속,757958,15,757958,0
4,발달상권,포스코사거리,시계및귀금속,46820742,134,46820742,0
4,골목상권,석관중앙교회,가구,11487607,122,8128023,3359584
4,발달상권,영등포역(영등포),부동산중개업,30672573,613,30672573,0
4,발달상권,노원역,시계및귀금속,526520107,37744,358227295,168292812
4,골목상권,송중초등학교,시계및귀금속,3117204,25,3117204,0
4,골목상권,한성대입구역 5번,가구,312292787,585,97292787,215000000
4,골목상권,은평구청,가구,5912736,20,4927280,985456
4,발달상권,방배역,시계및귀금속,67505612,586,61322538,6183074
4,골목상권,모래내우체국,시계및귀금속,41058201,132,30093404,10964797
4,발달상권,대치역,가전제품,3369427465,7492,2231982374,1137445091
4,골목상권,내를건너서숲으로도서관,가전제품,3882280,69,3882280,0
4,발달상권,장지역(가든파이브),가전제품,1064096340,918,1050577371,13518969
4,골목상권,까치산역 4번,시계및귀금속,88745856,287,81744224,7001632
4,골목상권,강동역 4번(강풀만화거리),시계및귀금속,219601,30,219601,0
4,골목상권,공항시장역 1번,시계및귀금속,95521252,182,90780449,4740803
4,골목상권,신설동역 12번,가구,4719764,118,4719764,0
4,골목상권,개화산역 1번,가전제품,376126455,3411,257049784,119076671
4,골목상권,뜸부기어린이공원,가구,305490363,590,264512095,40978268
4,골목상권,달마을공원,시계및귀금속,15728889,140,14158803,1570086
4,골목상권,암사역 2번(서울강동초등학교),가전제품,4322442400,1734,2626280447,1696161953
4,골목상권,천호지구대(천호동자전거거리),시계및귀금속,8778570,40,5068952,3709618
4,골목상권,화원중학교,가구,578746301,1347,384317262,194429039
4,골목상권,굽은다리역 3번,부동산중개업,719811,99,571679,148132
4,골목상권,굽은다리역 4번,시계및귀금속,6576560,214,6139604,436956
4,골목상권,효창공원앞역 5번,가구,35782394,60,35782394,0
4,골목상권,경의선책거리,가구,10143936,8,10143936,0
4,골목상권,해오름공원,시계및귀금속,12729666,139,6501556,6228110
4,골목상권,응암정보도서관,시계및귀금속,91442342,230,83197659,8244683
4,골목상권,아현역 1번,시계및귀금속,7124941,126,5968256,1156685
4,골목상권,동대문역 1번,가전제품,11359843,77,3601901,7757942
4,골목상권,관악구 중앙길,가구,1030805,14,1030805,0
4,골목상권,신풍역 1번,시계및귀금속,1729730,22,972973,756757
4,골목상권,노량진역 6번,시계및귀금속,583599,35,554708,28891
4,골목상권,신길3동주민센터,부동산중개업,25163440,4469,17285166,7878274
4,골목상권,장훈고등학교,시계및귀금속,13615145,48,13537344,77801
4,골목상권,구로4동주민센터,가전제품,100229171,2203,88495733,11733438
4,골목상권,서울대입구역 8번,시계및귀금속,45662,9,45662,0
4,골목상권,난곡초등학교(난곡동벽화마을),가구,16680407,43,13890004,2790403
4,골목상권,삼전역 4번,가전제품,168821,5,168821,0
4,골목상권,원신초등학교(구세군관악영문교회),가구,3807028,29,0,3807028
4,골목상권,시흥4동주민센터(서울신흥초등학교),가구,29535601,45,29535601,0
4,골목상권,신월7동주민센터,시계및귀금속,2133366,41,2051510,81856
4,골목상권,개봉1동주민센터,시계및귀금속,6538555,133,4167577,2370978
4,골목상권,상도역 5번,가전제품,7832618,21,3755365,4077253
4,골목상권,영등포동성당,가전제품,300078700,976,237064611,63014089
4,발달상권,상계백병원,시계및귀금속,1848873,40,1049361,799512
4,발달상권,양재화물트럭터미널앞,가구,3398147262,494,3077352442,320794820
4,발달상권,등나무근린공원,시계및귀금속,135126350,691,57635592,77490758
4,발달상권,"강남구청(청담역_8번, 강남세무서)",가구,6418354277,1082,2732171981,3686182296
4,발달상권,강남역,시계및귀금속,440775904,3064,313770131,127005773
4,발달상권,상봉역,가구,78205678,146,7904322,70301356
4,골목상권,신월3동주민센터,가전제품,142094175,826,108063691,34030484
4,발달상권,구로전화국,가전제품,193960914,908,124737575,69223339
4,발달상권,서울대입구역,시계및귀금속,364487898,692,298244435,66243463
4,발달상권,장지역(가든파이브),가구,2558195609,3031,809403026,1748792583
4,발달상권,목동사거리,시계및귀금속,32755386,144,28256020,4499366
4,발달상권,미아사거리역,시계및귀금속,68619819,810,44314180,24305639
4,발달상권,명동역(명동재미로),가전제품,69589038,8141,69589038,0
4,발달상권,도곡1동,가전제품,28000000,28,11254902,16745098
4,발달상권,충무로역,부동산중개업,721402516,64882,624350512,97052004
4,발달상권,석촌역(석촌호수),가구,485689716,437,417967663,67722053
4,발달상권,미아사거리,가전제품,159102380,466,130221795,28880585
4,발달상권,공릉역,가전제품,1216599614,2517,488308311,728291303
4,발달상권,성신여대,시계및귀금속,138871761,1080,63501965,75369796
4,발달상권,본서부병원,시계및귀금속,7549581,66,7130894,418687
4,발달상권,압구정로데오역(압구정로데오),시계및귀금속,2439234499,4416,1495043483,944191016
4,발달상권,이태원(이태원역),시계및귀금속,521836923,838,293158991,228677932
4,발달상권,"이화여대(이대역, 이대)",가구,53868186,528,53868186,0
4,발달상권,종로구청,시계및귀금속,2924792597,1934,2924792597,0
4,발달상권,청량리역(청량리),시계및귀금속,33767682,79,33300536,467146
4,발달상권,약수역,시계및귀금속,78961179,567,39534187,39426992
4,발달상권,용산전자상가(용산역),가구,5760853,56,4645849,1115004
4,발달상권,을지로3가역,가구,1215387441,7856,1184324762,31062679
4,발달상권,마포역,시계및귀금속,13321133,453,12969254,351879
4,발달상권,목동사거리,가구,297837967,581,177778840,120059127
4,발달상권,둔촌역,가구,205082828,296,112448022,92634806
4,발달상권,코엑스,시계및귀금속,9242980,15,9242980,0
4,발달상권,포이사거리(삼호물산),시계및귀금속,12950790,116,12868161,82629
4,발달상권,논현역 5번,가구,2076000000,859,1384000000,692000000
4,발달상권,신용산역(용산역),시계및귀금속,25801628,148,23307092,2494536
4,발달상권,신논현역,시계및귀금속,3264586781,2756,3264586781,0
4,발달상권,여의도역(여의도),시계및귀금속,434139006,1768,378017880,56121126
4,발달상권,신도림역,시계및귀금속,570340780,2636,485262720,85078060
4,발달상권,"총신대입구역(이수, 총신대)",시계및귀금속,308969977,814,266405785,42564192
4,전통시장,방산종합시장(방산시장),가구,1386000000,34689,1174039764,211960236
4,전통시장,창동역상점가,시계및귀금속,269866666,520,179590243,90276423
4,발달상권,"총신대입구역(이수, 총신대)",가구,117408053,200,117408053,0
4,발달상권,삼성역,시계및귀금속,1454118483,1472,1069251981,384866502
4,발달상권,구로전화국,가구,74642447,1241,33160635,41481812
4,발달상권,강동구청역,가전제품,4172767465,1830,2283129366,1889638099
4,발달상권,강남구청역,가구,1319653510,976,965970173,353683337
4,발달상권,방배동가구거리(사당동가구거리),가구,2148107868,3120,1353458423,794649445
4,발달상권,성수대교남단,시계및귀금속,498000000,1978,498000000,0
4,전통시장,대명여울빛거리시장(대명시장),시계및귀금속,21000000,169,19002507,1997493
4,전통시장,황학동주방가구거리상점가,가구,3511838549,8712,2813264267,698574282
4,전통시장,독산동 우시장,시계및귀금속,1690141,8,1690141,0
4,전통시장,정릉시장,시계및귀금속,29516932,369,5567803,23949129
4,전통시장,백학시장,가전제품,47261243,676,32462269,14798974
4,전통시장,연희사러가,가전제품,73933558,3191,50505391,23428167
4,전통시장,연희사러가,시계및귀금속,3876338,133,1282768,2593570
4,전통시장,전곡시장,가구,44874140,107,41327387,3546753
4,전통시장,신월3동 골목시장,가전제품,38381308,284,2806222,35575086
4,전통시장,황학동주방가구거리상점가,가전제품,226680388,725,225643399,1036989
4,전통시장,광장시장(광장전통시장),시계및귀금속,403055867,879,335450766,67605101
4,전통시장,행당시장상점가,가구,6453129,50,6453129,0
4,전통시장,"이화여대 3,5,7길 상점가",시계및귀금속,74235854,4773,46863939,27371915
4,전통시장,금남시장,시계및귀금속,172330756,377,118661698,53669058
4,전통시장,목2동시장,시계및귀금속,44212295,163,20159777,24052518
4,전통시장,"동대문종합시장(동대문종합시장 신관, 동대문종합시장D동상가)",시계및귀금속,3040896,211,3040896,0
4,전통시장,충신시장,시계및귀금속,69000000,54,65376636,3623364
4,전통시장,세종마을음식문화거리(금천교시장),시계및귀금속,3205882,235,3205882,0
4,전통시장,숭례문수입상가(남대문시장),가전제품,209679789,1814,171499511,38180278
4,전통시장,신노량진시장(기능상실),시계및귀금속,48510370,137,27875840,20634530
4,전통시장,영동전통시장,가구,49700450,45,49700450,0
4,전통시장,남구로시장,시계및귀금속,48853985,220,34816754,14037231
4,전통시장,봉천현대시장,시계및귀금속,38065744,138,32888803,5176941
4,전통시장,신림중앙시장(조원동 펭귄시장),시계및귀금속,31114901,54,18312388,12802513
4,전통시장,남성역골목시장,가구,50317516,50,50317516,0
4,전통시장,서서울 골목형상점가,가전제품,42194162,213,41407019,787143
4,전통시장,신원시장,시계및귀금속,1239519,6,1239519,0
4,전통시장,성대전통시장(성대시장),시계및귀금속,12656446,70,4990427,7666019
4,전통시장,석촌시장,가구,2525367,24,2124515,400852
4,전통시장,삼성동 시장(삼성동시장),시계및귀금속,5099718,46,5099718,0
4,관광특구,동대문패션타운 관광특구,시계및귀금속,749082488,3642,530283060,218799428
4,관광특구,잠실 관광특구,가구,16133358,46,16133358,0
4,골목상권,신림현대아파트,가구,47129165,238,47129165,0
4,골목상권,길상사,가구,7865247,8,2078991,5786256
4,골목상권,우장산역 4번,시계및귀금속,56499062,434,54726079,1772983
4,골목상권,가산초등학교(세일중학교),가구,682088226,1275,450239615,231848611
4,골목상권,상계2동주민센터,가전제품,499706737,1161,395833857,103872880
4,골목상권,쌍문2동우체국,가전제품,28490566,113,28490566,0
4,골목상권,수락산디자인거리,가구,111194006,256,50465300,60728706
4,골목상권,선정중학교,가구,2099694,28,325815,1773879
4,골목상권,장스여성병원,시계및귀금속,6900787,140,3198188,3702599
4,골목상권,망우본동주민센터,가구,32766785,11,32766785,0
4,골목상권,보문역 5번,시계및귀금속,6219544,70,4899747,1319797
4,골목상권,아차산역 5번,가구,1857619608,1621,755435833,1102183775
4,골목상권,면목5동주민센터,시계및귀금속,992751,20,992751,0
4,골목상권,상월곡역 1번,시계및귀금속,2127925,15,2127925,0
4,골목상권,이태원엔틱가구거리,가구,204036435,297,144312705,59723730
4,골목상권,서울역 15번,가구,14347377,102,13201517,1145860
4,골목상권,충정로역 7번,가구,51681504,164,12960050,38721454
4,골목상권,공항시장역 1번,가구,44571571,210,31970184,12601387
4,골목상권,오산중학교,시계및귀금속,5442126,33,5367889,74237
4,골목상권,발산역 5번,가구,12541283430,16563,5332392708,7208890722
4,골목상권,황학동벼룩시장,가전제품,168613047,680,130079747,38533300
4,골목상권,길동주민센터(강동도서관),시계및귀금속,77311390,156,77311390,0
4,골목상권,신월1파출소,시계및귀금속,4701493,15,4701493,0
4,골목상권,신월중학교,시계및귀금속,60203825,590,54611171,5592654
4,골목상권,신방화역 2번,시계및귀금속,136947800,353,92832580,44115220
4,골목상권,강서고등학교,시계및귀금속,19150369,59,19150369,0
4,골목상권,신당역 3번,가구,431989435,836,214684667,217304768
4,골목상권,망리단길,가전제품,566258104,487,279420056,286838048
4,골목상권,아현역 2번,가전제품,10680306,619,6802033,3878273
4,골목상권,구반포역,가전제품,21263059,374,19904397,1358662
4,골목상권,대림역 5번,시계및귀금속,3810599,70,3428533,382066
4,골목상권,삼전역 1번,가구,83766956,247,83766956,0
4,골목상권,은천초등학교(은천교앞),시계및귀금속,52554279,2153,52554279,0
4,골목상권,삼성산자연공원(서울금천초등학교),시계및귀금속,12479973,74,9180246,3299727
4,골목상권,방배초등학교,가구,81355025,81,81355025,0
4,골목상권,시흥4동주민센터(서울신흥초등학교),시계및귀금속,17107600,89,9697394,7410206
4,골목상권,구로4동주민센터,가구,118000000,33,118000000,0
4,골목상권,논현초등학교,가전제품,25696000,91,25696000,0
4,골목상권,노량진초등학교,가구,26234996,126,8112830,18122166
4,골목상권,서초중학교,시계및귀금속,15522127,244,15522127,0
4,골목상권,오류2동버들시장,가구,26442125,112,26442125,0
4,발달상권,한강성심병원,부동산중개업,160963026,11795,160963026,0
4,발달상권,등나무근린공원,가구,2081184290,2779,1192142592,889041698
4,발달상권,둔촌역,시계및귀금속,36122326,308,26559036,9563290
4,발달상권,공덕역(공덕오거리),부동산중개업,14062296,26,14062296,0
4,발달상권,노원역,가구,78304543,275,38022878,40281665
4,발달상권,청담사거리(청담동명품거리),가구,15235681466,3011,11133976861,4101704605
4,발달상권,까치산역,시계및귀금속,36898650,162,30728307,6170343
4,발달상권,양재역,시계및귀금속,116428794,1037,101947461,14481333
4,발달상권,학동역,가구,11554317705,13044,8388256705,3166061000
4,발달상권,명동역(명동재미로),시계및귀금속,2060862324,885,2060862324,0
4,발달상권,오금역,시계및귀금속,11280995,103,9685600,1595395
4,발달상권,도곡1동,가구,309792415,274,259424665,50367750
4,발달상권,연신내역,시계및귀금속,86558514,631,54262920,32295594
4,발달상권,목동역 8번출구,시계및귀금속,474976390,1288,316253971,158722419
4,발달상권,영등포역(영등포),가전제품,424547780,1565,222328424,202219356
4,발달상권,"강남구청(청담역_8번, 강남세무서)",가전제품,73833282,778,73833282,0
4,발달상권,동묘앞역(동묘),가전제품,69445872,342,60671123,8774749
4,발달상권,북촌(안국역),시계및귀금속,679183916,538,448038695,231145221
4,발달상권,구삼강변맛길,가구,45000000,161,29290263,15709737
4,발달상권,명일역,가구,6274880,42,3086387,3188493
4,발달상권,명동(명동거리),가전제품,41954471,22,10409756,31544715
4,발달상권,발산역(마곡),가구,3653741,37,3653741,0
4,발달상권,논현역,가구,9606986808,4392,6952596495,2654390313
4,발달상권,영등포구청역,부동산중개업,58793087,235,58793087,0
4,발달상권,고속터미널(고속터미널역),시계및귀금속,22003713893,40792,18566762421,3436951472
4,발달상권,개나리아파트,가구,290233314,308,192632730,97600584
4,발달상권,가산디지털단지,가전제품,1226789528,5628,403159315,823630213
4,전통시장,유진상가,시계및귀금속,28526470,246,27813185,713285
4,전통시장,"수유전통시장(수유시장, 수유골목시장)",가전제품,301453788,3046,247831914,53621874
4,전통시장,"수유전통시장(수유시장, 수유골목시장)",시계및귀금속,117306891,232,69720438,47586453
4,전통시장,우이골목시장(우이시장),가구,7220081,64,1789047,5431034
4,발달상권,강남구청역,시계및귀금속,112632677,370,45737081,66895596
4,발달상권,신림역(신림),가구,125197645,391,63576929,61620716
4,발달상권,르네상스호텔사거리,시계및귀금속,22756098,464,15682928,7073170
4,발달상권,송파사거리(송파역),가구,19233444,238,19233444,0
4,발달상권,대치사거리,부동산중개업,195000000,25980,152358826,42641174
4,전통시장,화양제일골목시장,시계및귀금속,33155683,19,33146048,9635
4,전통시장,이태원시장,시계및귀금속,2565805,38,2565805,0
4,전통시장,제일시장,가구,948175191,1336,556152410,392022781
4,전통시장,수유프라자,시계및귀금속,106624291,374,29461975,77162316
4,전통시장,방신전통시장,시계및귀금속,50502809,50,37760133,12742676
4,전통시장,"황학시장(서울중앙시장, 신중앙시장)",시계및귀금속,173618989,480,19549940,154069049
4,전통시장,청량리전통시장,시계및귀금속,69022423,128,57926801,11095622
4,전통시장,"황학시장(서울중앙시장, 신중앙시장)",가구,80397913,708,59650064,20747849
4,전통시장,길동복조리시장,시계및귀금속,56855390,293,55887457,967933
4,전통시장,망원월드컵시장,가구,54643462,164,27628716,27014746
4,전통시장,답십리 건축자재시장,가구,2490253454,61745,2490253454,0
4,전통시장,"평화시장(통일상가, 동화상가)",시계및귀금속,596549155,3322,377749727,218799428
4,전통시장,망원시장,시계및귀금속,11277845,66,11251483,26362
4,전통시장,강남터미널지하도상점가2구역,가구,169658638,2856,84674040,84984598
4,전통시장,영림시장,가구,4802568,80,4802568,0
4,전통시장,남대문시장(자유상가),가구,17579569,91,17579569,0
4,전통시장,사당시장,가전제품,1717168478,877,1215172326,501996152
4,관광특구,이태원 관광특구,가구,172776863,135,135321351,37455512
4,골목상권,신원동주민센터,시계및귀금속,66637494,257,33345366,33292128
4,골목상권,방배초등학교,시계및귀금속,2251838,134,2098528,153310
4,골목상권,영신여고,시계및귀금속,8395588,95,259415,8136173
4,골목상권,가산동우체국,시계및귀금속,66913871,83,58450287,8463584
4,골목상권,공릉역 2번,시계및귀금속,5891684,56,5791613,100071
4,골목상권,창덕궁,시계및귀금속,1965000000,3753,678448866,1286551134
4,골목상권,관악해태어린이공원,부동산중개업,870000000,7847,823557190,46442810
4,골목상권,영신초등학교,가구,309301360,765,187322410,121978950
4,골목상권,시흥동 은행나무사거리,시계및귀금속,12083938,80,12083938,0
4,골목상권,방학역 1번,가구,10785124,96,3115703,7669421
4,골목상권,중곡3동주민센터,가구,107387614,454,63211113,44176501
4,골목상권,성신여대운정그린캠퍼스,가구,967532591,2553,563314022,404218569
4,골목상권,호림박물관(성보고등학교),시계및귀금속,3934024,24,3934024,0
4,골목상권,문성초등학교,가전제품,387564122,3951,281134303,106429819
4,골목상권,상계초등학교,시계및귀금속,1927422,72,1653353,274069
4,골목상권,홍은종합사회복지관,시계및귀금속,70326326,218,31887888,38438438
4,골목상권,먹골역 5번,가전제품,3578169,169,3578169,0
4,골목상권,광산사거리,시계및귀금속,52871749,423,52871749,0
3,골목상권,당고개역 5번,가전제품,9385965,96,6894737,2491228
3,골목상권,쌍문2동우체국,가전제품,10943396,38,10943396,0
3,골목상권,제기동역 6번,부동산중개업,39185434,125,0,39185434
3,전통시장,난곡 골목형상점가,시계및귀금속,49861,5,49861,0
3,관광특구,동대문패션타운 관광특구,시계및귀금속,692771805,4111,532425135,160346670
3,발달상권,도곡1동,가전제품,14000000,5,11475410,2524590
3,발달상권,한티역,시계및귀금속,9424760,24,9424760,0
3,골목상권,양천향교역 5번,가전제품,23192693,116,18156411,5036282
3,골목상권,송파책박물관,가전제품,43203165,233,43203165,0
3,골목상권,관악구 중앙길,가구,2274882,14,2274882,0
3,발달상권,원남동사거리,시계및귀금속,11651746,127,11651746,0
3,발달상권,강서구청,가전제품,1144488,54,1144488,0
3,골목상권,성수초등학교,가전제품,15955827,31,15955827,0
3,골목상권,암사역 2번(서울강동초등학교),시계및귀금속,18605011,27,8395763,10209248
3,전통시장,회기시장,가전제품,107722923,293,107082771,640152
3,골목상권,상계2동주민센터,가전제품,233997676,625,150139871,83857805
3,전통시장,장위전통시장,시계및귀금속,20155207,47,16496141,3659066
3,전통시장,제일시장,시계및귀금속,607011924,2722,474752201,132259723
3,골목상권,금천금빛공원(은행나무사거리서측),가구,61640798,125,32017738,29623060
3,골목상권,고대앞사거리,가전제품,2272727,114,2272727,0
3,전통시장,청량리전통시장,가전제품,11260415,122,8715113,2545302
3,전통시장,사가정시장,시계및귀금속,14193562,95,11196075,2997487
3,골목상권,공릉역 2번,시계및귀금속,16255295,69,8956361,7298934
3,골목상권,먹골역 5번,가구,258763329,470,200018014,58745315
3,전통시장,남대문시장(자유상가),가전제품,155607580,952,143958161,11649419
3,전통시장,고덕 골목형상점가,시계및귀금속,13779377,218,13303757,475620
3,전통시장,광장시장(광장전통시장),시계및귀금속,404069499,622,354494430,49575069
3,골목상권,수락산역 4번,시계및귀금속,17280516,35,17280516,0
3,전통시장,망원월드컵시장,가구,49103618,115,34061316,15042302
3,골목상권,학동초등학교,가전제품,92181595,381,92181595,0
3,골목상권,서울지방병무청,가구,284447717,65,284447717,0
3,골목상권,방학초등학교,시계및귀금속,53441141,316,49735437,3705704
3,골목상권,석촌중학교(방이육교),가전제품,386409070,7039,338949461,47459609
3,골목상권,계상초등학교,가구,2829981,14,2829981,0
3,골목상권,강동구립성내도서관,시계및귀금속,1009440,5,1009440,0
3,발달상권,청담사거리(청담동명품거리),가구,8496768256,2017,7205137358,1291630898
3,발달상권,용산전자상가(용산역),가전제품,1.81E+11,481470,1.14E+11,66823238337
3,발달상권,종로3가역,시계및귀금속,1.78E+11,337965,1.36E+11,42032421374
3,골목상권,먹골역 1번,가구,254822733,328,175002523,79820210
3,골목상권,쌍문역1번(쌍리단길),시계및귀금속,11299435,39,10011299,1288136
3,골목상권,우장산역 4번,시계및귀금속,15523452,295,12588180,2935272
3,골목상권,먹골역 5번,시계및귀금속,28527050,246,11341814,17185236
3,발달상권,양재천카페거리,가구,14235267547,69676,10281562440,3953705107
3,골목상권,개봉1동주민센터,가전제품,14793629,153,13452909,1340720
3,골목상권,연천초등학교,시계및귀금속,5826600,102,5748808,77792
3,발달상권,미아사거리,시계및귀금속,804280039,3486,377568310,426711729
3,골목상권,은평세무서,가구,169351143,290,83675107,85676036
3,발달상권,공릉역,가전제품,1128474239,3253,658550117,469924122
3,골목상권,종암경찰서,시계및귀금속,98577315,269,80727475,17849840
3,발달상권,본서부병원,시계및귀금속,5407669,106,3948876,1458793
3,발달상권,월곡역,시계및귀금속,37076611,316,32682711,4393900
3,발달상권,인사동,시계및귀금속,336968736,9575,135778516,201190220
3,골목상권,경신고등학교,시계및귀금속,31188229,217,29643257,1544972
3,발달상권,"신촌역(신촌역, 신촌로터리)",시계및귀금속,710409999,1679,706045338,4364661
3,발달상권,홍대입구역(홍대),가구,1212000000,722,525360006,686639994
3,발달상권,서울남부지방법원,가전제품,387928367,615,304054683,83873684
3,골목상권,모래내우체국,시계및귀금속,8771311,200,7948265,823046
3,전통시장,성내전통시장,시계및귀금속,220386,22,110193,110193
3,골목상권,서일대학교,시계및귀금속,39666147,136,34137558,5528589
3,발달상권,가로수길,시계및귀금속,213000000,1868,38699878,174300122
3,골목상권,구립대학경로당(관악산샘말공원),부동산중개업,67610,9,67610,0
3,발달상권,종로4가,가전제품,97864208,375,97864208,0
3,전통시장,엔터식스 강남점,시계및귀금속,3633652,18,1858252,1775400
3,발달상권,노량진역(노량진),가구,642738106,945,475925173,166812933
3,발달상권,상봉역,시계및귀금속,404506778,929,332878864,71627914
3,발달상권,충무로역,시계및귀금속,55089051,94,55089051,0
3,골목상권,염곡동 구룡사(포이동성당),가구,73000000,17,73000000,0
3,골목상권,신림현대아파트,가전제품,34659352,235,34659352,0
3,골목상권,서강대역 1번,가전제품,289859,9,0,289859
3,발달상권,화곡역,시계및귀금속,35958284,72,35889269,69015
3,발달상권,신논현역,가구,872309586,514,872309586,0
3,골목상권,문성초등학교,가구,94361119,319,66285135,28075984
3,발달상권,신도림역,시계및귀금속,380727929,2057,234939668,145788261
3,골목상권,연신내역 3번,가구,338596145,708,205396408,133199737
3,발달상권,학동사거리,가구,14666698,776,13833486,833212
3,발달상권,강남역,가구,214541575,378,214541575,0
3,골목상권,남가좌파출소,시계및귀금속,17827737,157,17762001,65736
3,발달상권,서울세관,가구,719707999,231,600719781,118988218
3,골목상권,면목동우체국,가전제품,50751789,616,34294037,16457752
3,전통시장,아현가구거리상점가,가구,4216769370,4288,2495486388,1721282982
3,골목상권,가산초등학교(세일중학교),가구,746543085,1086,519101643,227441442
3,전통시장,방학동도깨비시장,시계및귀금속,97699097,448,77879415,19819682
3,골목상권,상신초등학교입구,시계및귀금속,6504958,39,6045326,459632
3,전통시장,창동골목시장,시계및귀금속,73096294,119,55686221,17410073
3,전통시장,우림골목시장,가구,87956957,432,46020770,41936187
3,발달상권,매봉역,가전제품,607283,23,448368,158915
3,발달상권,독산동,시계및귀금속,215806274,1615,200560013,15246261
3,골목상권,답십리사거리,가전제품,110316257,31,110316257,0
3,발달상권,강동구청역,가전제품,5628909670,2268,3257245643,2371664027
3,발달상권,역삼역,시계및귀금속,2875487,93,0,2875487
3,발달상권,목동신시가지,가전제품,6814563,41,0,6814563
3,발달상권,삼성중앙역,가구,2039432091,849,551392248,1488039843
3,전통시장,남문시장,시계및귀금속,37217635,60,22944642,14272993
3,골목상권,성원중학교,가전제품,272155254,496,233112145,39043109
3,골목상권,공항시장역 3번,시계및귀금속,53923865,128,40266991,13656874
3,골목상권,중곡역 3번,시계및귀금속,22402166,61,13464514,8937652
3,전통시장,방신전통시장,시계및귀금속,22220041,110,16147358,6072683
3,골목상권,이대역 5번,가전제품,34657040,116,34657040,0
3,전통시장,중부시장(신중부시장),가구,4364562893,178362,4275084627,89478266
3,전통시장,연희사러가,가전제품,102445662,4256,71793603,30652059
3,전통시장,동묘시장(동묘벼룩시장),가전제품,62193968,730,62193968,0
3,전통시장,뚝섬역상점가,시계및귀금속,42051875,208,39277700,2774175
3,골목상권,청담초등학교,시계및귀금속,2309558770,3295,1129024262,1180534508
3,전통시장,목사랑시장(목4동시장),시계및귀금속,88580951,316,76337485,12243466
3,전통시장,"중곡제일시장(중곡제일골목시장, 광성시장)",시계및귀금속,75566153,223,42876268,32689885
3,골목상권,달마을공원,시계및귀금속,25771825,152,24100805,1671020
3,전통시장,"황학시장(서울중앙시장, 신중앙시장)",가구,1124627694,1887,1088318959,36308735
3,전통시장,길동복조리시장,시계및귀금속,18313392,313,13079027,5234365
3,전통시장,제일평화시장,시계및귀금속,243520000,533,217386667,26133333
3,전통시장,"평화시장(통일상가, 동화상가)",시계및귀금속,449251805,3578,315038468,134213337
3,골목상권,뜸부기어린이공원,가구,109064344,652,91519183,17545161
3,골목상권,신월1파출소,시계및귀금속,22447761,52,21701492,746269
3,전통시장,신곡종합시장(신월6동 골목시장),시계및귀금속,66352815,337,54774178,11578637
3,전통시장,목동깨비시장(목3동시장),시계및귀금속,7269791,32,7226870,42921
3,골목상권,응암정보도서관,시계및귀금속,133662049,231,129489171,4172878
3,골목상권,아현역 1번,시계및귀금속,11426736,186,11337303,89433
3,전통시장,석촌시장,시계및귀금속,79279018,188,45415178,33863840
3,전통시장,관악신사시장,가구,125953180,456,82736739,43216441
3,골목상권,망리단길,가전제품,336571081,379,313234186,23336895
3,전통시장,삼성동 시장(삼성동시장),시계및귀금속,90662,23,90662,0
3,골목상권,신풍역 1번,시계및귀금속,3783784,22,3783784,0
3,골목상권,남천초등학교,시계및귀금속,24967330,136,19588095,5379235
3,관광특구,동대문패션타운 관광특구,가전제품,55813061,545,53969525,1843536
3,골목상권,방배초등학교,시계및귀금속,44469512,114,44469512,0
3,골목상권,중앙고등학교,시계및귀금속,322395745,3751,297409616,24986129
3,골목상권,영등포역 2번,부동산중개업,25928972,3140,19887851,6041121
3,골목상권,방배아이파크아파트,가구,2889014824,4284,1985589418,903425406
3,골목상권,구로초등학교,시계및귀금속,26187354,62,26187354,0
3,골목상권,마천역(마천초등학교),가구,117429368,448,71333038,46096330
3,골목상권,서울대입구역 8번,시계및귀금속,45662,9,45662,0
3,골목상권,등촌1동주민센터,가구,582947287,1084,502827006,80120281
3,골목상권,신림역 8번,가구,687733127,1890,209222050,478511077
3,골목상권,봉천역 6번,시계및귀금속,48424659,51,42589632,5835027
3,골목상권,신대방삼거리역 3번,가구,18308288,54,15835786,2472502
3,골목상권,양지어린이공원,시계및귀금속,29165555,84,8760058,20405497
3,골목상권,학동근린공원,시계및귀금속,83271214,138,83271214,0
3,골목상권,개봉1동주민센터,시계및귀금속,29166362,146,23502731,5663631
3,발달상권,한강성심병원,부동산중개업,228000000,13909,228000000,0
3,골목상권,구산역 1번,가구,265876590,258,111166634,154709956
3,골목상권,연신내역 7번,시계및귀금속,16731129,750,12836696,3894433
3,발달상권,양재화물트럭터미널앞,가구,833307255,190,833307255,0
3,발달상권,군자역,가구,4193253934,5109,2307166491,1886087443
3,발달상권,오류동역,시계및귀금속,149847906,651,121807158,28040748
3,발달상권,논현역,가전제품,30175919,312,16648783,13527136
3,골목상권,수락산디자인거리,시계및귀금속,5574261,87,5208739,365522
3,발달상권,구파발역,시계및귀금속,322703132,382,273485618,49217514
3,발달상권,구산역,시계및귀금속,52271069,324,49078742,3192327
3,골목상권,인수동 우편취급국,가구,21998020,319,19128713,2869307
3,골목상권,신월3동주민센터,가전제품,100513881,450,69075123,31438758
3,골목상권,쌍문2동우체국,가구,29255687,126,29255687,0
3,발달상권,구로전화국,시계및귀금속,229424298,742,182750608,46673690
3,발달상권,장지역(가든파이브),가구,2443552467,2829,1274158684,1169393783
3,골목상권,중화역 4번,시계및귀금속,43563795,99,21670012,21893783
3,골목상권,먹골역 5번,가전제품,2523989,265,2523989,0
3,발달상권,미아사거리역,시계및귀금속,390405712,7816,260813601,129592111
3,골목상권,장스여성병원,시계및귀금속,20852611,172,17954924,2897687
3,발달상권,합정역,시계및귀금속,78281076,464,62300715,15980361
3,골목상권,장안중학교,시계및귀금속,46972956,133,12407951,34565005
3,골목상권,응암정보도서관,가전제품,26079619,139,26079619,0
3,발달상권,서대문역,시계및귀금속,27363067,268,27363067,0
3,발달상권,이태원(이태원역),시계및귀금속,387512139,1241,292216517,95295622
3,발달상권,도산공원교차로,가구,1522625960,851,1189058637,333567323
3,발달상권,영등포역(영등포),시계및귀금속,9617761598,83414,5103554150,4514207448
3,발달상권,"강남구청(청담역_8번, 강남세무서)",가전제품,117334413,1108,117334413,0
3,발달상권,종로구청,시계및귀금속,3265894885,2434,3250647235,15247650
3,발달상권,구의사거리,시계및귀금속,40518309,241,39820702,697607
3,발달상권,홍대입구역(홍대),시계및귀금속,78118856,900,59033160,19085696
3,발달상권,인사동,가전제품,67558144,229,67349631,208513
3,발달상권,논현역,가구,15152169690,5970,10816836243,4335333447
3,골목상권,KB국민은행 망원동지점,가구,18528689,14,18528689,0
3,발달상권,고덕역,가구,617848,12,0,617848
3,골목상권,신길2동우편취급국,시계및귀금속,127518820,1432,124415056,3103764
3,발달상권,화곡역,가전제품,175326574,1770,91138543,84188031
3,골목상권,공항시장역 3번,가구,7900178,75,7900178,0
3,발달상권,역삼역,가구,39099562,557,8570929,30528633
3,골목상권,신월3동주민센터,가구,8010899,49,6376022,1634877
3,발달상권,구역삼세무서,가구,283341459,147,147678220,135663239
3,골목상권,금호삼성래미안아파트,시계및귀금속,12381837,40,8816678,3565159
3,골목상권,화곡역 4번,가구,25659467,329,25659467,0
3,전통시장,로데오거리상점가,시계및귀금속,155328342,706,107433160,47895182
3,골목상권,곰달래도서관,시계및귀금속,52441952,197,37961400,14480552
3,골목상권,성원중학교,가구,56591034,135,3119191,53471843
3,골목상권,구의역 4번,시계및귀금속,70735993,246,61074334,9661659
3,전통시장,우림골목시장,시계및귀금속,21699563,75,16228441,5471122
3,전통시장,도화동 상점가,시계및귀금속,195417953,664,161040433,34377520
3,골목상권,굽은다리역 4번,가전제품,551815,22,551815,0
3,골목상권,경리단길남측,시계및귀금속,6711284,479,4656809,2054475
3,골목상권,목동보건지소,시계및귀금속,25217324,237,18932715,6284609
3,발달상권,신림역(신림),가구,231322212,514,167500755,63821457
3,골목상권,화곡초등학교,시계및귀금속,1530139,62,1320453,209686
3,발달상권,개봉동 현대아파트,가구,53807752,167,53807752,0
3,발달상권,포이사거리(삼호물산),가전제품,83234709,447,83234709,0
3,발달상권,잠실역,시계및귀금속,290504617,1810,279698143,10806474
3,발달상권,송파사거리(송파역),가구,19498108,295,9631441,9866667
3,골목상권,능동우편취급국,가구,72638347,161,67041214,5597133
3,전통시장,대명여울빛거리시장(대명시장),시계및귀금속,12608775,290,9145222,3463553
3,골목상권,동대문역 1번,가전제품,82458915,200,41852864,40606051
3,전통시장,관악중부시장,시계및귀금속,51496233,185,20205813,31290420
3,골목상권,신방화역 2번,가전제품,4800401123,3282,2962405325,1837995798
3,전통시장,수유프라자,가구,126494085,315,118783880,7710205
3,골목상권,천호공원(해공체육문화센터),가구,12235370,48,2519047,9716323
3,골목상권,강동역 4번(강풀만화거리),가전제품,33200074,163,33200074,0
3,전통시장,서울중앙시장(신중앙시장),가구,11953994265,26670,11170565153,783429112
3,골목상권,해방촌 남동측,시계및귀금속,25252174,120,24893479,358695
3,전통시장,청량리전통시장,시계및귀금속,3622019,64,2219124,1402895
3,전통시장,동묘시장(동묘벼룩시장),시계및귀금속,15885397,141,9529572,6355825
3,골목상권,대청초등학교,시계및귀금속,59011474,368,58636493,374981
3,골목상권,언주역 6번,가구,267258133,160,194065789,73192344
3,전통시장,대림상가(청계상가),가전제품,5988024598,15335,5087446773,900577825
3,골목상권,장훈고등학교,시계및귀금속,9196058,62,1633817,7562241
3,전통시장,답십리 건축자재시장,가구,3151546678,56034,3151546678,0
3,전통시장,신당 미래유산 먹거리 골목형상점가,시계및귀금속,6925041,66,4430714,2494327
3,골목상권,석촌역 6번,시계및귀금속,95061290,105,95061290,0
3,전통시장,금남시장,시계및귀금속,190006159,449,141939915,48066244
3,골목상권,상도역 5번,시계및귀금속,23738334,155,23509376,228958
3,전통시장,종로신진시장,시계및귀금속,138952065,633,124592277,14359788
3,전통시장,홍대 걷고싶은 거리,시계및귀금속,140654967,1109,86287395,54367572
3,전통시장,신노량진시장(기능상실),시계및귀금속,4119583,64,1327421,2792162
3,전통시장,마천중앙시장,가전제품,68611599,656,44156806,24454793
3,골목상권,남성역 1번,시계및귀금속,69992588,250,54090486,15902102
3,골목상권,남구로역 2번,가구,5787234,31,4237082,1550152
3,전통시장,개봉중앙시장,시계및귀금속,9288682,102,7990841,1297841
3,전통시장,남구로시장,가구,43121222,211,33843677,9277545
3,전통시장,연서시장,시계및귀금속,73673899,312,51038699,22635200
3,골목상권,삼성산자연공원(서울금천초등학교),시계및귀금속,26176604,99,26176604,0
3,전통시장,낙원시장(낙원지하시장(대일상가)),가전제품,1323659857,9714,1171093949,152565908
3,전통시장,사당1동먹자골목상점가(사당1동먹자골목),부동산중개업,141738878,109,7268660,134470218
3,전통시장,신원시장,시계및귀금속,4923369,12,4923369,0
3,전통시장,도곡시장,시계및귀금속,624413246,647,622190501,2222745
3,골목상권,신월7동주민센터,시계및귀금속,24439064,97,24413484,25580
3,골목상권,시흥4동주민센터(서울신흥초등학교),시계및귀금속,2990357,72,1356015,1634342
3,관광특구,잠실 관광특구,가구,103999920,84,81871474,22128446
3,관광특구,명동 남대문 북창동 다동 무교동 관광특구,시계및귀금속,17282006097,61771,13164143493,4117862604
3,관광특구,명동 남대문 북창동 다동 무교동 관광특구,가구,95929891,213,80926638,15003253
3,관광특구,명동 남대문 북창동 다동 무교동 관광특구,가전제품,342640762,2731,308819952,33820810
3,관광특구,강남 마이스 관광특구,가구,8443170204,4794,4215188146,4227982058
3,골목상권,남구로역 3번,가구,148761818,442,93606483,55155335
3,골목상권,방이역 1번,가구,12878686,19,7891352,4987334
3,골목상권,영신여고,시계및귀금속,542412,24,542412,0
3,발달상권,상계백병원,가구,12379686,22,2807764,9571922
3,골목상권,신림현대아파트,가구,109527054,303,38605576,70921478
3,골목상권,국악고교사거리,가전제품,219902510,290,219902510,0
3,골목상권,남구로역 5번,가전제품,15334895,98,7527440,7807455
3,골목상권,사당5동주민센터,가전제품,7257669,51,7257669,0
3,발달상권,가산디지털단지,가전제품,2689254714,10744,2588986688,100268026
3,발달상권,서울대입구역,가구,52403153,288,32794342,19608811
3,발달상권,학동역,가구,12132584889,14976,7391463161,4741121728
3,발달상권,오금역,시계및귀금속,4710708,95,4573469,137239
3,골목상권,인헌고등학교(인헌중학교),시계및귀금속,45280340,452,39599715,5680625
3,발달상권,합정역,가구,14931429,224,0,14931429
3,골목상권,방학중학교,시계및귀금속,20424412,82,18724524,1699888
3,골목상권,상계2동주민센터,가구,21392583,54,19482531,1910052
3,골목상권,상계초등학교,시계및귀금속,13238740,66,11927974,1310766
3,발달상권,홍제역,가구,30489782,191,16975089,13514693
3,발달상권,강남을지병원,시계및귀금속,993445042,638,631107902,362337140
3,발달상권,강변역(테크노마트),시계및귀금속,303927576,3383,175207435,128720141
3,골목상권,수락산역 4번,가전제품,117000000,361,66638885,50361115
3,발달상권,상수역(홍대),부동산중개업,639064565,42100,473444276,165620289
3,발달상권,암사역,시계및귀금속,14494943,107,6182261,8312682
3,발달상권,강남을지병원,가구,722840058,713,435682157,287157901
3,골목상권,서울여자간호대학교,시계및귀금속,13718750,42,13718750,0
3,골목상권,망우역 1번,가전제품,4068426968,9988,2773791676,1294635292
3,발달상권,을지로3가역,가구,122419778,2373,112353700,10066078
3,골목상권,돌곶이역 5번,시계및귀금속,38559985,98,37098457,1461528
3,골목상권,중화역 4번,가구,23819443,94,22805866,1013577
3,발달상권,목동사거리,가전제품,3822791806,7831,2933593900,889197906
3,골목상권,보문역 5번,시계및귀금속,14259307,71,14204315,54992
3,발달상권,여의도역(여의도),시계및귀금속,180812091,2274,180026395,785696
3,발달상권,여의도역(여의도),가전제품,194300,6,194300,0
3,골목상권,홍릉시장,가전제품,1111363636,1251,736363636,375000000
3,골목상권,강동역 4번(강풀만화거리),시계및귀금속,878406,44,878406,0
3,골목상권,이태원엔틱가구거리,가구,395373627,435,304299168,91074459
3,전통시장,방산종합시장(방산시장),가구,1358502091,41929,1070417988,288084103
3,골목상권,장안근린공원,시계및귀금속,17430123,53,17008341,421782
3,전통시장,영천시장,시계및귀금속,111462953,418,111200181,262772
3,전통시장,창동역상점가,시계및귀금속,122523577,338,92279673,30243904
3,전통시장,강북종합전통시장(강북종합골목시장),시계및귀금속,11415411,65,1076773,10338638
3,발달상권,구로디지털단지,가전제품,43324413,188,11324413,32000000
3,골목상권,오산중학교,시계및귀금속,16309246,74,15127168,1182078
3,발달상권,석촌역(석촌호수),시계및귀금속,40348154,102,36200778,4147376
3,발달상권,선릉역,가구,584965803,16867,536906976,48058827
3,발달상권,대림3동사거리,가구,23409736,132,23409736,0
3,발달상권,석촌고분역,시계및귀금속,35950018,137,32326277,3623741
3,골목상권,KB국민은행 망원동지점,시계및귀금속,79734829,242,63425872,16308957
3,발달상권,보라매역,시계및귀금속,1671130,135,1057819,613311
3,전통시장,남대문시장(자유상가),시계및귀금속,2575298015,47521,1951031628,624266387
3,전통시장,은행나무시장,시계및귀금속,909463,36,909463,0
3,전통시장,화양제일골목시장,시계및귀금속,3528807,27,1854039,1674768
3,전통시장,대조시장,가구,2931209,39,2931209,0
3,전통시장,밤나무골시장,시계및귀금속,4524736,12,4524736,0
3,전통시장,백학시장,가전제품,22304548,265,16204613,6099935
3,전통시장,창신골목시장,시계및귀금속,1905483,22,1905483,0
3,전통시장,성동용답상가시장,시계및귀금속,188624937,406,173955396,14669541
3,전통시장,제일시장,가구,1125281566,1682,773928473,351353093
3,전통시장,"황학시장(서울중앙시장, 신중앙시장)",시계및귀금속,95326757,480,74852035,20474722
3,전통시장,응암오거리상점가,시계및귀금속,16231047,43,231047,16000000
3,전통시장,연희사러가,시계및귀금속,17664330,147,14790372,2873958
3,골목상권,암사역 2번(서울강동초등학교),가전제품,4632627621,2123,3180001391,1452626230
3,전통시장,백학시장,시계및귀금속,4604366,10,4604366,0
3,전통시장,송화벽화시장(송화골목시장),시계및귀금속,17066848,130,15305219,1761629
3,골목상권,화원중학교,가구,524101679,1044,370845625,153256054
3,골목상권,암사동성당(효정하나플러스아파트),시계및귀금속,11550863,127,11472374,78489
3,골목상권,신방화역 2번,시계및귀금속,104555275,469,87436095,17119180
3,전통시장,숭례문수입상가(남대문시장),시계및귀금속,40174754,365,40174754,0
3,전통시장,신영시장,가구,12616773,211,8544805,4071968
3,전통시장,고척골목시장상점가(그라운드 고척),시계및귀금속,29514707,27,29474680,40027
3,골목상권,아현역 2번,가전제품,12589337,674,6956099,5633238
3,전통시장,공덕시장,시계및귀금속,8098472,254,7517826,580646
3,전통시장,용산용문시장,시계및귀금속,19158032,66,18772669,385363
3,전통시장,서서울 골목형상점가,가전제품,35003280,344,25770744,9232536
3,관광특구,동대문패션타운 관광특구,가구,3707855918,13815,3275192142,432663776
3,관광특구,종로?청계 관광특구,가전제품,2290012628,16297,1927698471,362314157
3,관광특구,강남 마이스 관광특구,가전제품,55855797,130,55855797,0
3,골목상권,구로4동주민센터,가전제품,120561365,2507,104007798,16553567
3,골목상권,그라운드 고척,시계및귀금속,18778958,56,18742761,36197
3,골목상권,경찰병원역 3번,가구,18303285,18,18303285,0
3,골목상권,사근동살곶이상점가,시계및귀금속,8020101,669,7773870,246231
3,골목상권,노원초등학교,가전제품,30575836,14,25398234,5177602
3,골목상권,문정역 2번,시계및귀금속,7052604,201,7052604,0
3,골목상권,서울역 15번,가구,14347377,78,11537004,2810373
3,골목상권,신정역 5번,시계및귀금속,4122847,75,3648208,474639
3,골목상권,충정로역 7번,가구,39842614,135,28802844,11039770
3,골목상권,금산초등학교(금천고등학교),시계및귀금속,29860465,80,29827242,33223
3,골목상권,방배초등학교,가구,12203254,81,12203254,0
3,골목상권,신월문화체육센터,시계및귀금속,3041380,24,144828,2896552
3,골목상권,상도역 5번,가전제품,8744636,22,8744636,0
3,골목상권,개화산역 1번,가전제품,285614834,2689,219327311,66287523
3,골목상권,마포구청역 4번,가전제품,10480491465,4070,7460209045,3020282420
3,발달상권,강남역,시계및귀금속,486014378,3759,358969487,127044891
3,골목상권,화곡역 4번,시계및귀금속,6579445,40,3063711,3515734
3,전통시장,왕십리도선동상점가,시계및귀금속,34139165,152,16919869,17219296
3,전통시장,행당시장상점가,시계및귀금속,52404440,118,42455477,9948963
3,골목상권,굽은다리역 3번,부동산중개업,489384,110,440007,49377
3,골목상권,대흥역 2번,시계및귀금속,169487740,668,145903552,23584188
3,전통시장,인현시장,시계및귀금속,30411841,180,28777349,1634492
3,전통시장,고분다리전통시장,시계및귀금속,32857541,57,32857541,0
3,골목상권,경의선책거리,가구,55359153,24,18007452,37351701
3,골목상권,신방화역 2번,가구,10232383,47,6296851,3935532
3,전통시장,선유도역 골목형상점가,시계및귀금속,417724315,1487,417014417,709898
3,골목상권,해오름공원,가구,15456289,318,12027419,3428870
3,골목상권,신당역 3번,가구,337829493,885,230896552,106932941
3,골목상권,명지대학교,시계및귀금속,26887486,219,12150286,14737200
3,골목상권,창신역 1번,시계및귀금속,8435344,44,3572223,4863121
3,골목상권,방화역 3번,시계및귀금속,22261412,569,18506040,3755372
3,골목상권,솔숲어린이공원,가구,640292,8,185891,454401
3,전통시장,중랑동부시장(중랑교종합상가),시계및귀금속,4936955,30,4936955,0
3,전통시장,방이시장,시계및귀금속,25944796,300,23473863,2470933
3,전통시장,대림중앙 골목형상점가,부동산중개업,15521375,705,11758617,3762758
3,전통시장,동남상가,시계및귀금속,165049789,765,107728373,57321416
3,전통시장,서원동상점가,시계및귀금속,147494939,1122,95913858,51581081
3,전통시장,불광먹자골목 골목형상점가,시계및귀금속,153373784,308,140269526,13104258
3,전통시장,강남시장(강남구 강남시장),가구,18164776,18,18164776,0
3,골목상권,응암3동주민센터,가구,50410971,180,24772995,25637976
3,전통시장,목동깨비시장(목3동시장),가구,46392247,199,19436507,26955740
3,전통시장,세운상가가동,가전제품,2163839306,15653,1802184579,361654727
3,전통시장,충신시장,시계및귀금속,46000000,30,46000000,0
3,전통시장,망원시장,시계및귀금속,11959973,171,8062288,3897685
3,전통시장,세종마을음식문화거리(금천교시장),시계및귀금속,4823529,352,4588235,235294
3,전통시장,숭례문수입상가(남대문시장),가전제품,185617804,1613,163446413,22171391
3,전통시장,고척근린시장,시계및귀금속,13841908,54,11925505,1916403
3,골목상권,묘곡초등학교(고덕아이파크아파트),시계및귀금속,1306393,108,762063,544330
3,골목상권,금천구청역 1번 출입구,시계및귀금속,85483323,280,78032599,7450724
3,전통시장,남구로시장,시계및귀금속,31091914,110,19320535,11771379
3,골목상권,신월2동주민센터,시계및귀금속,26741168,634,14970030,11771138
3,전통시장,봉천현대시장,시계및귀금속,12949966,129,12812929,137037
3,전통시장,화곡중앙시장,가구,107224402,75,90974738,16249664
3,골목상권,자양한강도서관,시계및귀금속,11314585,100,11314585,0
3,전통시장,영림시장,부동산중개업,762032387,5886,762032387,0
3,골목상권,문성초등학교,시계및귀금속,38549793,74,11367341,27182452
3,관광특구,종로?청계 관광특구,시계및귀금속,10973060418,21142,7855739698,3117320720
3,골목상권,난곡초등학교(난곡동벽화마을),가구,13083889,62,7937146,5146743
3,골목상권,신원동주민센터,시계및귀금속,70260245,347,70110094,150151
3,골목상권,시흥4동주민센터(서울신흥초등학교),가구,21992663,46,21992663,0
3,골목상권,가산동우체국,시계및귀금속,58576610,99,58576610,0
3,골목상권,거여역 1번(거여공원),가전제품,255807295,522,214510301,41296994
3,골목상권,노량진초등학교,가구,7164577,63,7164577,0
3,발달상권,사당역(사당),시계및귀금속,21867736,474,18237422,3630314
3,발달상권,등나무근린공원,가구,1704827160,2808,864296510,840530650
3,발달상권,등나무근린공원,시계및귀금속,79623125,603,47145322,32477803
3,발달상권,노원역,시계및귀금속,425922759,1897,284835513,141087246
3,골목상권,시흥초등학교(시흥1동우체국),시계및귀금속,1949889,35,1858962,90927
3,골목상권,남구로역 5번,시계및귀금속,91691227,295,55539475,36151752
3,발달상권,"강남구청(청담역_8번, 강남세무서)",가구,1453459841,596,1105849754,347610087
3,골목상권,신림역 8번,가전제품,5825584062,2524,2895812716,2929771346
3,발달상권,수유역,시계및귀금속,479210176,1150,414491494,64718682
3,발달상권,노원역,가구,179698886,376,117958766,61740120
3,골목상권,개봉1동주민센터,가구,92647653,288,27983373,64664280
3,골목상권,신대방역 4번,시계및귀금속,3413033,28,3413033,0
3,골목상권,시흥초등학교(시흥1동우체국),가구,18452555,70,18452555,0
3,발달상권,연희동,시계및귀금속,13089510,58,13089510,0
3,발달상권,방배역,시계및귀금속,63899644,576,52600936,11298708
3,골목상권,푸른들청소년도서관,시계및귀금속,22175744,188,18932914,3242830
3,발달상권,신림역(신림),시계및귀금속,133915576,1634,84265551,49650025
3,발달상권,양재역,시계및귀금속,167635590,1087,163467909,4167681
3,골목상권,원신초등학교(구세군관악영문교회),가전제품,75664175,249,75664175,0
3,골목상권,문성초등학교,가전제품,519907995,3855,309269917,210638078
3,발달상권,서교동(홍대),시계및귀금속,42451928,223,41083503,1368425
3,발달상권,압구정역,시계및귀금속,3012542736,25927,1569844961,1442697775
3,골목상권,도봉산입구,시계및귀금속,111516130,340,80984022,30532108
3,발달상권,충무로역,부동산중개업,508882785,51136,443451070,65431715
3,발달상권,성신여대,시계및귀금속,151708604,1166,95309606,56398998
3,발달상권,대학로(혜화역),시계및귀금속,45227434,487,41240850,3986584
3,발달상권,성신여대,가구,71296435,696,70451219,845216
3,발달상권,한성대입구역,시계및귀금속,6496767,268,3836217,2660550
3,골목상권,평창동서측,시계및귀금속,3233435,14,3233435,0
3,발달상권,롯데백화점(시청광장 지하쇼핑센터),시계및귀금속,13708891960,7201,10562074994,3146816966
3,골목상권,방학역 1번,시계및귀금속,18172578,85,16968450,1204128
3,발달상권,삼청동,가구,177839694,149,166000000,11839694
3,골목상권,홍은종합사회복지관,시계및귀금속,28416988,229,16084655,12332333
3,발달상권,광화문역,시계및귀금속,136171015,565,136171015,0
3,발달상권,아차산역,가구,408013817,722,339560672,68453145
3,발달상권,상봉역,가전제품,1216927200,3099,825185101,391742099
3,골목상권,수락산역 4번,가구,8227858,33,1611642,6616216
3,골목상권,망우본동주민센터,시계및귀금속,54476315,256,30935616,23540699
3,발달상권,신당역,가전제품,61405063,159,61405063,0
3,골목상권,창2동주민센터,가구,20878170,21,20878170,0
3,발달상권,천호역,가구,254017844,963,172892092,81125752
3,골목상권,돌곶이역 5번,가전제품,76405007,265,49915842,26489165
3,발달상권,등촌역,시계및귀금속,34150260,199,34150260,0
3,발달상권,장안동사거리,가구,14045890,142,11983456,2062434
3,골목상권,장스여성병원,가전제품,6000000,23,5350760,649240
3,발달상권,합정역,가전제품,32843853,165,6556041,26287812
3,골목상권,공릉동 국수거리,가구,65928890,106,55261096,10667794
3,발달상권,고속터미널(고속터미널역),시계및귀금속,15477814152,32512,13166791895,2311022257
3,골목상권,새절역 2번,시계및귀금속,12123450,69,12123450,0
3,발달상권,논현역 5번,가구,2076000000,1392,734455946,1341544054
3,발달상권,논현역,시계및귀금속,135067737,261,127776465,7291272
3,발달상권,신논현역,시계및귀금속,16257094090,4501,9988341517,6268752573
3,골목상권,아차산역 5번,가구,1859055226,2432,913585313,945469913
3,발달상권,학동역,시계및귀금속,13816597,185,11379462,2437135
3,골목상권,신내1동주민센터,시계및귀금속,85521785,96,81329541,4192244
3,발달상권,목동신시가지,가구,987837819,413,662201456,325636363
3,골목상권,내를건너서숲으로도서관,가전제품,5814794,104,5814794,0
3,골목상권,동대문중앙새마을금고본점,가구,1833333,33,1833333,0
3,골목상권,고려대역 4번,가구,852291,21,0,852291
3,골목상권,장안1동주민센터,가전제품,254436898,1004,224387153,30049745
3,전통시장,인헌시장(원당종합시장),시계및귀금속,19611932,84,7082253,12529679
3,전통시장,우림골목시장,가전제품,48417253,273,42955175,5462078
3,발달상권,구로전화국,가구,304591766,1147,190965514,113626252
3,발달상권,삼성역,시계및귀금속,2788643414,1605,2595875729,192767685
3,발달상권,삼성역,가전제품,55855797,130,55855797,0
3,발달상권,교육개발원입구사거리,가전제품,147056687,5115,147056687,0
3,골목상권,황학코아루아파트,시계및귀금속,8762175,41,8724802,37373
3,발달상권,내방역,가전제품,16699140,5,16699140,0
3,골목상권,신월1동주민센터,가구,54984290,80,16795201,38189089
3,발달상권,석촌고분역,가구,384063471,348,237909567,146153904
3,골목상권,석촌고분역 1번,가구,416947643,55,416947643,0
3,골목상권,동교초등학교,시계및귀금속,28616097,96,28453966,162131
3,골목상권,둔촌동역 1번(한산중학교),시계및귀금속,6398072,76,6363977,34095
3,전통시장,우림시장,시계및귀금속,76267202,429,42715186,33552016
3,전통시장,황학동주방가구거리상점가,가구,3828186201,7244,3559082946,269103255
3,골목상권,등촌3동주민센터,가구,162431815,269,48939896,113491919
3,전통시장,공릉동 도깨비시장,시계및귀금속,9864010,62,8720658,1143352
3,전통시장,방천골목시장,시계및귀금속,69418948,140,60178919,9240029
3,전통시장,회기시장,시계및귀금속,23904633,276,23361347,543286
3,전통시장,수유프라자,시계및귀금속,288166175,514,234386379,53779796
3,전통시장,전곡시장,시계및귀금속,7998788,16,7998788,0
3,전통시장,전곡시장,가구,10331847,31,3084133,7247714
3,전통시장,신월3동 골목시장,가전제품,43265556,409,43105708,159848
3,전통시장,황학동주방가구거리상점가,가전제품,307105222,751,240924838,66180384
3,전통시장,암사종합시장,시계및귀금속,12588834,90,9001404,3587430
3,골목상권,우장산힐스테이트,부동산중개업,38042775,48,0,38042775
3,전통시장,노룬산시장(노룬산골목시장),시계및귀금속,89868113,133,63870266,25997847
3,전통시장,전농로터리시장,가구,3848210,10,0,3848210
3,골목상권,성동구보건소,가전제품,38652973,766,38652973,0
3,전통시장,도림시장,시계및귀금속,28961557,109,26555292,2406265
3,전통시장,방이시장,가구,17181889,145,17181889,0
3,골목상권,모래내우체국,가전제품,6929599881,3344,4063529563,2866070318
3,골목상권,체부동홍종문가옥,시계및귀금속,3587881,120,3587881,0
3,전통시장,숭인시장,시계및귀금속,8142857,130,5529100,2613757
3,전통시장,사당시장,가전제품,1155685449,857,985448620,170236829
3,골목상권,마천역(마천초등학교),시계및귀금속,73581790,342,59175901,14405889
3,골목상권,대림성모병원,시계및귀금속,2637314,113,935821,1701493
3,관광특구,잠실 관광특구,시계및귀금속,316224475,1757,307182338,9042137
3,관광특구,이태원 관광특구,가구,143856328,92,98664656,45191672
3,관광특구,강남 마이스 관광특구,시계및귀금속,2794457547,1620,2601689862,192767685
3,골목상권,송파나루역 2번,시계및귀금속,37605428,154,34354960,3250468
3,골목상권,노량진역 6번,시계및귀금속,635604,35,531596,104008
3,골목상권,논현2동주민센터,시계및귀금속,121864815,208,43846834,78017981
3,골목상권,구반포역,가전제품,41948689,510,41948689,0
3,골목상권,창2동주민센터,시계및귀금속,7907877,17,4545155,3362722
3,골목상권,덕의초등학교,시계및귀금속,1732977,55,1530182,202795
3,골목상권,도봉역 2번,가전제품,93257143,1065,93257143,0
3,골목상권,대림썬프라자,시계및귀금속,5290148,20,3657566,1632582
3,골목상권,구로디지털단지역 4번,가구,118697759,296,47824772,70872987
3,골목상권,푸른동산공원,시계및귀금속,39000000,34,39000000,0
3,골목상권,남구로역 2번,시계및귀금속,36962394,69,36962394,0
3,골목상권,마천1치안센터,가전제품,62655270,148,60079608,2575662
3,골목상권,삼전역 1번,가구,74036451,106,56408725,17627726
3,골목상권,영신초등학교,가구,298859035,728,159604603,139254432
3,골목상권,삼전역 4번,시계및귀금속,12366908,206,4491209,7875699
3,골목상권,포이초등학교(개포목련어린이공원),가구,1399128987,4622,695747019,703381968
3,골목상권,아차산역 1번,가전제품,148476523,730,140243352,8233171
3,골목상권,우리은행응암동지점,시계및귀금속,18507165,497,9883179,8623986
3,골목상권,헌인가구단지,가구,233417091,438,132525256,100891835
3,골목상권,중곡3동주민센터,가구,113235696,356,87251425,25984271
3,골목상권,거여역 1번(거여공원),가구,18163001,28,16765847,1397154
3,골목상권,충정로역 6번,가구,1252999977,2280,866783384,386216593
3,골목상권,성자초등학교,가구,12340348,76,7548984,4791364
3,골목상권,광진정말공원,가구,6020067,54,4816054,1204013
3,골목상권,신정네거리역 2번,가구,42221510,127,25807100,16414410
3,골목상권,대동초등학교,시계및귀금속,44966590,66,34076672,10889918
3,발달상권,상계백병원,시계및귀금속,2938208,80,2878245,59963
3,발달상권,가산디지털단지,부동산중개업,7957373,5,7957373,0
3,골목상권,서초소방서,가구,276000000,211,213699075,62300925
3,골목상권,샘말어린이공원,가전제품,386481,13,386481,0
3,골목상권,도봉구 정병원,가전제품,1377378775,1124,1308490675,68888100
3,발달상권,상봉역,가구,37584791,188,15023447,22561344
3,골목상권,행당역 2번,시계및귀금속,26490989,161,20210721,6280268
3,골목상권,까치산역 1번,시계및귀금속,3541932,18,3541932,0
3,골목상권,도봉구보건소,시계및귀금속,138938536,606,138763435,175101
3,골목상권,4.19민주묘지역 2번,시계및귀금속,66726236,291,57164765,9561471
3,골목상권,석관중앙교회,가구,45787868,217,25332342,20455526
3,골목상권,역촌노인복지관,시계및귀금속,2295929,37,2149204,146725
3,골목상권,외대앞역 1번,가구,7457604,27,5344469,2113135
3,발달상권,명동역(명동재미로),가전제품,191000927,9927,191000927,0
3,골목상권,상봉역 4번,가전제품,8519956,60,8519956,0
3,발달상권,공릉역,시계및귀금속,22161434,113,19636642,2524792
3,발달상권,"신촌역(신촌역, 신촌로터리)",가전제품,2645668,9,0,2645668
3,골목상권,상봉역 4번,가구,127711978,264,100582780,27129198
3,발달상권,압구정로데오역(압구정로데오),시계및귀금속,2539636158,5927,1519660334,1019975824
3,발달상권,강변역(테크노마트),가전제품,8715213532,20458,6403922141,2311291391
3,골목상권,청량초등학교,가구,61941847,272,43632093,18309754
3,발달상권,동묘앞역(동묘),가전제품,103255176,411,103255176,0
3,발달상권,신설동역,가전제품,56103897,172,49213944,6889953
3,골목상권,러스크서울병원,시계및귀금속,39586206,87,37336989,2249217
3,골목상권,보문역 4번,가구,120907582,366,95040387,25867195
3,발달상권,사가정역,시계및귀금속,26875211,128,21045661,5829550
3,발달상권,약수역,시계및귀금속,117432046,486,90647796,26784250
3,발달상권,성수대교남단,가구,218537690,185,180130453,38407237
3,발달상권,왕십리역(왕십리),시계및귀금속,459532656,5726,382407586,77125070
3,발달상권,용산전자상가(용산역),시계및귀금속,119152653,555,118364490,788163
3,골목상권,방화역 3번,가구,887097,6,887097,0
3,발달상권,용산전자상가(용산역),가구,7247526,38,3716680,3530846
3,골목상권,까치산역 4번,시계및귀금속,75637987,266,68165835,7472152
3,발달상권,을지로4가역,가구,6368580638,5164,5180684997,1187895641
3,발달상권,이태원(이태원역),가구,40000000,18,0,40000000
3,골목상권,자양4동주민센터,가구,18119474,89,16394725,1724749
3,발달상권,목동사거리,가구,110362215,360,84471602,25890613
3,발달상권,둔촌역,가구,254103190,294,142052899,112050291
3,발달상권,문래역(문래로데오거리),시계및귀금속,691100319,4956,622744600,68355719
3,발달상권,목동역 8번출구,가구,56446281,133,40743802,15702479
3,발달상권,성수역,가전제품,42000000,51,28465319,13534681
3,발달상권,어린이대공원역,가전제품,111745865,338,111745865,0
3,골목상권,공항시장역 1번,가구,89843220,396,65573883,24269337
3,발달상권,포스코사거리,가전제품,3891000000,108772,3714933266,176066734
3,발달상권,대치역,시계및귀금속,8453757,650,5852601,2601156
3,발달상권,신대방삼거리역,시계및귀금속,27720466,399,21497505,6222961
3,발달상권,신도림역,가전제품,1453566691,7560,970274013,483292678
3,발달상권,은마아파트,가구,25744789,45,25744789,0
3,발달상권,오목교역,가구,583037785,39,583037785,0
3,골목상권,홍대부속여중고앞,시계및귀금속,1566607,37,1566607,0
3,발달상권,"총신대입구역(이수, 총신대)",시계및귀금속,280111828,658,253695248,26416580
3,골목상권,푸른들청소년도서관,가구,37606206,42,17758486,19847720
3,전통시장,영등포역지하도상점가,시계및귀금속,2335582338,2483,937336699,1398245639
3,골목상권,장훈고등학교,가구,36718834,204,21419320,15299514
3,전통시장,청량리수산시장,가구,178749442,534,155219224,23530218
3,전통시장,유진상가,시계및귀금속,23927013,236,19730932,4196081
3,골목상권,화곡2동주민센터,가구,11809582,32,11415929,393653
3,전통시장,"수유전통시장(수유시장, 수유골목시장)",시계및귀금속,184931849,271,162765477,22166372
3,골목상권,화원중학교,시계및귀금속,52126584,77,51903925,222659
3,발달상권,강남구청역,시계및귀금속,67853237,103,47144423,20708814
3,골목상권,신월중학교,시계및귀금속,81000000,136,73580153,7419847
3,발달상권,"총신대입구역(이수, 총신대)",가구,1306953224,1016,1157325289,149627935
3,발달상권,구로디지털단지역,시계및귀금속,159131754,805,88120394,71011360
3,발달상권,문정역,가구,1699466579,400,1220068390,479398189
3,발달상권,대림3동사거리,시계및귀금속,22018009,107,7367457,14650552
3,골목상권,효창공원앞역 5번,가구,15786350,120,8269040,7517310
3,발달상권,남부터미널역,시계및귀금속,149809820,2958,115470392,34339428
3,발달상권,대치사거리,부동산중개업,195000000,26918,145300717,49699283
3,골목상권,동묘앞역 2번,시계및귀금속,11002172,70,11002172,0
3,골목상권,강서고등학교,시계및귀금속,69329000,88,61101920,8227080
3,골목상권,전농1동주민센터(전농시장),가구,81818182,91,81818182,0
3,전통시장,풍납시장,시계및귀금속,17920086,248,17676077,244009
3,전통시장,중랑동부시장,가전제품,218892242,726,207777936,11114306
3,전통시장,정릉시장,시계및귀금속,23932355,198,21451311,2481044
3,전통시장,신아타운,시계및귀금속,21389928,112,19394948,1994980
3,골목상권,장승배기역 5번,가구,12000000,23,10772727,1227273
3,골목상권,구반포역,시계및귀금속,525925776,1878,499092828,26832948
3,골목상권,남구로역 3번,가전제품,4310092,174,3235169,1074923
3,전통시장,까치산시장,시계및귀금속,93968002,413,87589188,6378814
3,전통시장,영등포유통상가,가전제품,368028391,1362,248971539,119056852
3,골목상권,성수동카페거리,가전제품,7048777,144,7048777,0
3,전통시장,수일시장,시계및귀금속,94574007,190,94574007,0
3,전통시장,화곡본동시장,가구,1489637,20,993091,496546
3,골목상권,독산동정훈단지,가구,10568769,20,8555670,2013099
3,골목상권,원신초등학교(구세군관악영문교회),가구,10249692,88,6442664,3807028
3,골목상권,선일여고,시계및귀금속,7147906,18,7147906,0
3,전통시장,신림중앙시장(조원동 펭귄시장),시계및귀금속,29639138,65,26811490,2827648
3,골목상권,신풍역 6번(신길6동공영주차장),가구,93643199,286,62652159,30991040
3,전통시장,성대전통시장(성대시장),시계및귀금속,1803769,40,1803769,0
3,관광특구,이태원 관광특구,시계및귀금속,388139121,1280,292843499,95295622
3,골목상권,벌말어린이공원,시계및귀금속,5689655,256,4405530,1284125
3,골목상권,신월시영아파트중문,가구,158759614,197,126062225,32697389
3,발달상권,사당역(사당),부동산중개업,30646539,2370,22146539,8500000
3,발달상권,양재화물트럭터미널앞,시계및귀금속,2728650,60,2728650,0
3,발달상권,영등포역(영등포),부동산중개업,24538058,613,24538058,0
3,발달상권,송파사거리(송파역),시계및귀금속,40575711,240,40501589,74122
3,골목상권,만리재,시계및귀금속,16183353,67,11128443,5054910
3,골목상권,관악해태어린이공원,부동산중개업,870000000,8907,776240601,93759399
3,골목상권,시흥동 은행나무사거리,시계및귀금속,10224871,66,7665285,2559586
3,골목상권,한울중학교,가구,12495831,23,12495831,0
3,골목상권,신월3동주민센터,시계및귀금속,9392264,102,8162038,1230226
3,발달상권,오금역,가전제품,12899338,48,12899338,0
3,발달상권,구로전화국,가전제품,675257275,2173,337402152,337855123
3,발달상권,서울대입구역,시계및귀금속,236514753,703,201914538,34600215
3,발달상권,장지역(가든파이브),가전제품,369282181,708,339802002,29480179
3,발달상권,까치산역,시계및귀금속,67179607,170,67179607,0
3,발달상권,선정릉역,시계및귀금속,43333333,155,43333333,0
3,골목상권,포이초등학교(개포목련어린이공원),가전제품,1752380603,861,1752380603,0
3,발달상권,연신내역,시계및귀금속,67817538,626,54483474,13334064
3,발달상권,미아사거리,가전제품,53160310,582,24285549,28874761
3,골목상권,독산동성당,시계및귀금속,14577947,52,12848767,1729180
3,발달상권,성북구청,가전제품,70481697,945,59935021,10546676
3,발달상권,홍제역,시계및귀금속,91064579,541,72706152,18358427
3,발달상권,신정네거리역,가구,1164160192,1088,454945260,709214932
3,발달상권,신설동역,시계및귀금속,46160452,373,35749004,10411448
3,발달상권,종로4가,시계및귀금속,16265281757,22008,12005938976,4259342781
3,발달상권,구삼강변맛길,가구,45000000,149,22562007,22437993
3,골목상권,경춘선숲길 우측,시계및귀금속,26397506,103,12568403,13829103
3,발달상권,중구청(퇴계로4가),가구,3701554437,5093,3636977786,64576651
3,골목상권,신창초등학교,가구,70031792,99,68836482,1195310
3,골목상권,광산사거리,시계및귀금속,12728088,283,12728088,0
3,골목상권,상월곡역 3번,가전제품,22444596,112,22444596,0
3,골목상권,광운대역 1번,시계및귀금속,8664175,130,8193162,471013
3,발달상권,서대문역,가전제품,14467174,30,14467174,0
3,발달상권,명일역,시계및귀금속,108634359,612,87559320,21075039
3,골목상권,구산보건지소,가구,14090909,182,14090909,0
3,발달상권,종각역,시계및귀금속,1844122231,11872,1304763508,539358723
3,발달상권,굽은다리역,시계및귀금속,22146091,98,18022692,4123399
3,발달상권,구의역,시계및귀금속,43877829,502,42723983,1153846
3,골목상권,석계역 2번,시계및귀금속,12669101,203,7068770,5600331
3,골목상권,송중초등학교,시계및귀금속,1825908,48,1727210,98698
3,골목상권,상월곡역 1번,가전제품,209884312,736,146641981,63242331
3,골목상권,시립서북병원,시계및귀금속,13771235,110,9173437,4597798
3,발달상권,선릉역,시계및귀금속,25236226,37,25236226,0
3,발달상권,대치사거리,가구,1018983055,1905,802987360,215995695
3,발달상권,서울세관,시계및귀금속,167316078,2122,167225264,90814
3,발달상권,압구정로데오역(압구정로데오),가전제품,107912313,31,107912313,0
3,골목상권,건대입구역 6번,시계및귀금속,8058788,29,8058788,0
3,전통시장,비단길현대시장(현대시장),시계및귀금속,158228611,272,143354244,14874367
3,골목상권,등촌3동주민센터,시계및귀금속,129719707,593,125006916,4712791
3,전통시장,"수유전통시장(수유시장, 수유골목시장)",가전제품,385499680,2141,310122744,75376936
3,골목상권,공항시장역 1번,시계및귀금속,40365065,278,36033737,4331328
3,발달상권,서울대입구역,가전제품,2529742125,7437,1857613767,672128358
3,발달상권,강남구청역,가구,1225695702,610,972019378,253676324
3,골목상권,신설동역 12번,가구,13569322,354,11681416,1887906
3,전통시장,관악중부시장,가구,104226719,151,22274485,81952234
3,전통시장,"솔샘시장(미아6,7동골목시장)",시계및귀금속,155859376,714,124648398,31210978
3,골목상권,은평요양병원,가구,1539192,19,1539192,0
3,발달상권,석촌고분역,가전제품,14068415,5,14068415,0
3,골목상권,자양동우체국,시계및귀금속,8050008,69,8050008,0
3,골목상권,서문여고,가구,9843958,407,9843958,0
3,발달상권,을지로4가역,시계및귀금속,4794353,87,435851,4358502
3,발달상권,발산역(마곡),가구,54806122,37,54806122,0
3,발달상권,성수대교남단,시계및귀금속,205439224,1110,205439224,0
3,전통시장,충신시장,가전제품,28940934,126,25445564,3495370
3,전통시장,월정로시장,가구,27672414,78,2502155,25170259
3,골목상권,뜸부기어린이공원,시계및귀금속,15853768,23,14904213,949555
3,발달상권,상수역(홍대),가구,129336974,116,42532338,86804636
3,발달상권,오금역,가구,184639006,170,184639006,0
3,골목상권,방학1동주민센터,가전제품,189594,5,189594,0
3,골목상권,숭곡초등학교,가전제품,7477419,16,7477419,0
3,골목상권,종로5가역 4번,시계및귀금속,59705094,124,59705094,0
3,골목상권,영신초등학교,가전제품,215421536,1398,215421536,0
3,발달상권,장한평역(장한평),시계및귀금속,23134750,218,22728269,406481
3,전통시장,월정로시장,시계및귀금속,4712277,41,1729823,2982454
3,발달상권,교대역(법원.검찰청),부동산중개업,385455,193,385455,0
3,발달상권,독산동,가전제품,12000000,5,12000000,0
3,골목상권,성동세무서,시계및귀금속,7202841,42,4124704,3078137
3,전통시장,장미원골목시장,시계및귀금속,1420845,96,1420845,0
3,골목상권,두산초등학교,가구,57195301,90,57195301,0
3,전통시장,영림시장,시계및귀금속,55855712,358,44793412,11062300
3,골목상권,신길3동주민센터,부동산중개업,24646062,3293,19048960,5597102
3,골목상권,오류2동버들시장,시계및귀금속,10281650,111,3439545,6842105
3,골목상권,보라매역 2번,시계및귀금속,7666667,230,7500000,166667
3,골목상권,영신초등학교,시계및귀금속,55172340,123,36426320,18746020
3,골목상권,당곡중학교,시계및귀금속,13360568,45,9313266,4047302
3,골목상권,봉천역 4번(봉천110안전센터),가구,186898012,753,44482419,142415593
3,골목상권,방배역 3번,가구,19366263,31,19366263,0
3,골목상권,은천초등학교(은천교앞),시계및귀금속,45839199,814,45839199,0
3,골목상권,삼전역 4번,가전제품,675284,5,675284,0
3,골목상권,관악구신사동주민센터,가전제품,19614430,149,13936570,5677860
3,골목상권,사당역 10번,시계및귀금속,586558668,658,563285390,23273278
3,골목상권,성자초등학교,시계및귀금속,99000000,176,99000000,0
3,골목상권,영등포동성당,가전제품,395392081,976,365896124,29495957
3,발달상권,창동역,시계및귀금속,79917644,541,79019598,898046
3,발달상권,목동사거리,시계및귀금속,13714068,162,7342966,6371102
3,발달상권,금호역,시계및귀금속,39223097,232,36455087,2768010
3,발달상권,장안동사거리,시계및귀금속,16065161,1008,15139512,925649
3,발달상권,삼호가든사거리,시계및귀금속,73604546,642,71821490,1783056
3,발달상권,잠실새내역(신천),시계및귀금속,152872516,1233,113265436,39607080
3,발달상권,연신내역,가전제품,92455689,876,68722088,23733601
3,발달상권,한성대입구역,가구,100139437,156,91115589,9023848
3,발달상권,본서부병원,가전제품,1877512378,5598,1326079919,551432459
3,발달상권,본서부병원,가구,17181079,70,13522146,3658933
3,발달상권,충정로역,시계및귀금속,8663102,72,8663102,0
3,발달상권,신용산역(용산역),시계및귀금속,109676463,972,109676463,0
3,발달상권,"이화여대(이대역, 이대)",가구,69182399,217,51075446,18106953
3,발달상권,종로3가역,가전제품,9337005,146,8677575,659430
3,발달상권,월드컵경기장역(월드컵경기장),시계및귀금속,47688030,1519,34725956,12962074
3,발달상권,길동역,가구,8107293,295,6808289,1299004
3,발달상권,명동(명동거리),시계및귀금속,388396081,1950,127819520,260576561
3,발달상권,동대문역,시계및귀금속,14830601,50,13489982,1340619
3,발달상권,아차산역,가전제품,546196918,2086,382239859,163957059
3,발달상권,어린이대공원역,시계및귀금속,14076018,136,13525512,550506
3,발달상권,포이사거리(삼호물산),시계및귀금속,71529563,187,67761660,3767903
3,발달상권,경찰병원역,시계및귀금속,17731219,132,11230876,6500343
3,발달상권,뱅뱅사거리,시계및귀금속,52357285,190,40361550,11995735
3,발달상권,서래마을카페거리(서래마을),가구,567114458,1574,314856347,252258111
3,발달상권,신용산역(용산역),가구,8598000000,7208,4376137571,4221862429
3,전통시장,고척근린시장,가구,171422821,639,118993806,52429015
3,전통시장,창동신창시장,시계및귀금속,72143925,165,52086908,20057017
3,전통시장,우이골목시장(우이시장),가구,9711968,96,9711968,0
3,전통시장,대조시장,시계및귀금속,22467181,58,1491049,20976132
3,발달상권,"총신대입구역(이수, 총신대)",가전제품,619698253,1921,403187665,216510588
3,발달상권,르네상스호텔사거리,시계및귀금속,25682927,659,25073171,609756
3,발달상권,구로구청,가전제품,108000000,329,72972019,35027981
3,전통시장,뚝도시장,시계및귀금속,89782476,303,89782476,0
3,전통시장,독산동 맛나는거리상점가(독산동 맛나는거리),시계및귀금속,74375928,80,45034965,29340963
3,전통시장,중랑동부시장,시계및귀금속,45425779,209,39547610,5878169
3,전통시장,강북북부골목시장,시계및귀금속,17000658,111,11762767,5237891
3,전통시장,화곡본동시장,시계및귀금속,15663708,180,13587054,2076654
3,전통시장,"이화여대 3,5,7길 상점가",시계및귀금속,52856148,3044,27376148,25480000
3,전통시장,목2동시장,시계및귀금속,26913534,108,13589204,13324330
3,전통시장,능동로골목시장,시계및귀금속,61086005,197,47195349,13890656
3,전통시장,신정1동 골목시장(신정제일시장),시계및귀금속,11658248,71,10498864,1159384
3,전통시장,"동대문종합시장(동대문종합시장 신관, 동대문종합시장D동상가)",시계및귀금속,8995985,465,5701681,3294304
3,전통시장,소공지하도상가,시계및귀금속,334742287,4275,248539597,86202690
3,전통시장,"동원전통종합시장(동원시장, 동원전통시장 상점가)",가구,168839596,675,95576318,73263278
3,전통시장,우리시장,시계및귀금속,6793503,6,0,6793503
3,전통시장,영동전통시장,가구,17666251,45,17666251,0
3,전통시장,새마을시장,시계및귀금속,14429044,191,2733059,11695985
3,전통시장,남성사계시장(남성시장),시계및귀금속,108546401,622,96959811,11586590
3,전통시장,강남터미널지하도상점가2구역,가구,81016673,2384,51388938,29627735
3,전통시장,남대문시장(자유상가),가구,95929891,213,80926638,15003253
3,전통시장,미성동 도깨비시장 골목형상점가,시계및귀금속,15991115,61,13059207,2931908
3,전통시장,관악신사시장,시계및귀금속,129513840,272,118409345,11104495
3,전통시장,문정동 로데오거리 상점가(문정동 로데오거리),시계및귀금속,11144643,97,10983282,161361
3,전통시장,도곡시장,가구,16298428,113,12505996,3792432
3,전통시장,상도도깨비 골목형상점가,시계및귀금속,10350516,68,10254296,96220
3,전통시장,까치산시장,가전제품,7170361,229,4543382,2626979
3,골목상권,암사역 1번,시계및귀금속,65140931,300,61030545,4110386
3,골목상권,언주역 3번,가구,154333812,232,154333812,0
3,골목상권,창덕궁,시계및귀금속,2111012706,4307,686491553,1424521153
3,골목상권,광진정말공원,시계및귀금속,51835505,370,49168432,2667073
3,골목상권,성신여대운정그린캠퍼스,가구,748916693,2254,474766672,274150021
3,골목상권,용산구청,시계및귀금속,626982,39,626982,0
3,골목상권,호림박물관(성보고등학교),시계및귀금속,2446006,49,2446006,0
3,골목상권,영서중학교,시계및귀금속,7907761,53,7907761,0
3,골목상권,삼성산자연공원(서울금천초등학교),가구,16293068,76,2163923,14129145
3,골목상권,신성초등학교,가구,142140650,266,103594033,38546617
3,골목상권,수락산디자인거리,가구,18099369,64,18099369,0
3,골목상권,하나고등학교,가구,1000000,4,993912,6088
3,골목상권,수유시장옆,시계및귀금속,11590500,63,11590500,0
3,골목상권,방학역 1번,가전제품,1119911843,4029,980160694,139751149
3,골목상권,수송초등학교,가구,35308134,21,35308134,0
3,골목상권,상계역,시계및귀금속,576923,38,576923,0
3,골목상권,계상초등학교,시계및귀금속,11434459,63,11316901,117558
3,골목상권,종암아이파크2차,시계및귀금속,38636527,180,23241740,15394787
3,골목상권,종암동주민센터,시계및귀금속,1409375,256,1409375,0
3,골목상권,선정중학교,가구,1831802,14,1831802,0
3,골목상권,수유동우체국,가구,26157880,150,22059067,4098813
3,골목상권,숭곡초등학교,시계및귀금속,73628819,156,62278463,11350356
3,골목상권,연신내우체국,시계및귀금속,12000000,12,12000000,0
3,골목상권,삼양입구사거리,가구,1845182,12,1845182,0
3,골목상권,구산보건지소,시계및귀금속,1391813,164,1391813,0
3,골목상권,상월곡역 1번,시계및귀금속,10904987,25,9653267,1251720
3,골목상권,면목역 3번,시계및귀금속,2095808,7,2095808,0
3,골목상권,양천향교역 5번,가구,575435108,400,575435108,0
3,골목상권,황학동벼룩시장,가전제품,58549726,261,50172495,8377231
3,골목상권,성원중학교,시계및귀금속,54906793,228,54906793,0
3,골목상권,염창역 2번,가전제품,190048,34,162898,27150
3,골목상권,성수119안전센터,시계및귀금속,67202,6,67202,0
3,골목상권,길동주민센터(강동도서관),시계및귀금속,17962024,165,12540846,5421178
3,골목상권,천호지구대(천호동자전거거리),시계및귀금속,4733723,41,3628574,1105149
3,골목상권,화양사거리,시계및귀금속,2468828,90,2468828,0
3,골목상권,화곡2동주민센터,시계및귀금속,7481593,34,7340003,141590
3,골목상권,해방촌예술마을,가전제품,64028188,556,63424148,604040
3,골목상권,굽은다리역 4번,시계및귀금속,10738752,192,10635068,103684
3,골목상권,해오름공원,시계및귀금속,18727120,162,13309643,5417477
3,골목상권,자양4동주민센터,시계및귀금속,16971429,79,13394861,3576568
3,골목상권,동대부고,가전제품,1194917419,2878,963101247,231816172
3,골목상권,태릉시장 특화거리,가전제품,93240295,359,49718151,43522144
3,골목상권,장안제일시장,시계및귀금속,12147692,48,12147692,0
3,골목상권,신대방역 3번,부동산중개업,4117488,352,3008934,1108554
3,골목상권,구로4동주민센터,시계및귀금속,180967,24,87363,93604
3,골목상권,아현역 2번,시계및귀금속,128081,10,0,128081
3,골목상권,대림역 5번,시계및귀금속,9662228,70,6796739,2865489
3,골목상권,문정초등학교,시계및귀금속,3568332,10,3568332,0
3,골목상권,용두동신동아아파트,시계및귀금속,58096103,126,57242853,853250
3,골목상권,남부초등학교,시계및귀금속,22778,6,22778,0
3,골목상권,독산동정훈단지,시계및귀금속,67844321,134,51069432,16774889
3,골목상권,난우초등학교,가구,59603742,186,36258167,23345575
3,골목상권,관악구신사동주민센터,가구,22203540,64,22203540,0
3,골목상권,대동초등학교,가구,219697580,550,183615082,36082498
3,골목상권,동대문역 1번,시계및귀금속,824709,29,790346,34363
3,골목상권,서강대학교,가전제품,294802971,400,172747924,122055047
3,골목상권,논현초등학교,가전제품,57874286,23,57874286,0
3,골목상권,NH농협은행 상도동지점,시계및귀금속,62817219,276,49150601,13666618
3,골목상권,서초중학교,시계및귀금속,26532400,275,26195694,336706
3,골목상권,오류2동버들시장,가구,7570916,56,7570916,0
3,발달상권,마들역,시계및귀금속,11260022,157,7710188,3549834
3,발달상권,둔촌역,시계및귀금속,70184000,391,65447108,4736892
3,발달상권,대치역,가전제품,4028459039,9445,2331645019,1696814020
3,발달상권,천호역,시계및귀금속,1141303458,2230,803019811,338283647
3,발달상권,청담사거리(청담동명품거리),시계및귀금속,4623261072,5493,3118301928,1504959144
3,발달상권,명동역(명동재미로),시계및귀금속,470756634,1568,470756634,0
3,발달상권,도곡1동,가구,175579237,65,175579237,0
3,발달상권,석촌역(석촌호수),가구,930967926,625,569316564,361651362
3,발달상권,미아사거리역,가전제품,513953992,7697,346323163,167630829
3,발달상권,신정네거리역,시계및귀금속,149998254,471,148050707,1947547
3,발달상권,강변역(테크노마트),가구,1658747596,2171,1004267496,654480100
3,발달상권,목동역 8번출구,시계및귀금속,390169284,1274,290298405,99870879
3,발달상권,영등포역(영등포),가전제품,487737350,1704,270805488,216931862
3,발달상권,영등포역(영등포),가구,1430325329,4115,706299982,724025347
3,발달상권,청량리역(청량리),시계및귀금속,21365275,133,21130846,234429
3,발달상권,서촌(경복궁역),시계및귀금속,17676874,11,17676874,0
3,발달상권,홍대입구역(홍대),가전제품,15368030,7,15368030,0
3,발달상권,마포역,시계및귀금속,92802269,581,92299585,502684
3,발달상권,삼청동,시계및귀금속,10981980,281,7874857,3107123
3,발달상권,명일역,가구,5430185,28,5430185,0
3,발달상권,서촌(경복궁역),가전제품,302105946,642,302105946,0
3,발달상권,건대입구역(건대),시계및귀금속,652143050,3885,455216535,196926515
3,발달상권,동대문역사문화공원역,시계및귀금속,78085542,297,77398790,686752
3,발달상권,목동신시가지,시계및귀금속,335521426,2759,209211658,126309768
3,발달상권,등촌역,부동산중개업,641972,143,427981,213991
3,발달상권,서울역,시계및귀금속,56988078,6643,54987514,2000564
3,발달상권,등촌역,가구,2738264281,3135,1625623199,1112641082
3,발달상권,오목교역,시계및귀금속,1215811709,1594,1181956404,33855305
3,발달상권,구의사거리,가구,156854585,475,131300138,25554447
3,발달상권,코엑스,가구,8443170204,4794,4215188146,4227982058
3,발달상권,코엑스,시계및귀금속,5814133,15,5814133,0
3,발달상권,개나리아파트,가구,507180575,223,158386911,348793664
3,발달상권,신도림역,가구,2671796668,2890,1394893598,1276903070
3,발달상권,신용산역(용산역),가전제품,5469223459,15917,3042251858,2426971601
3,발달상권,학동사거리,시계및귀금속,635144994,419,452230397,182914597
3,전통시장,남부종합시장,시계및귀금속,2053783,29,2053783,0
3,전통시장,삼양골목시장(삼양시장),시계및귀금속,4631325,44,995984,3635341
3,전통시장,"남부골목시장(남부화곡시장, 남부시장)",시계및귀금속,39477157,271,37714303,1762854
3,전통시장,공릉동 도깨비시장,가구,7024238,40,7024238,0
3,전통시장,장위전통시장,가전제품,51319899,908,40656613,10663286
3,발달상권,신사역,가구,894000000,5455,770927984,123072016
3,발달상권,가산디지털단지,가구,230313260,1148,230313260,0
3,발달상권,가산디지털단지,시계및귀금속,39885982,977,38975956,910026
3,발달상권,사당역(사당),가구,1025903886,10144,847196737,178707149
3,발달상권,장지역(가든파이브),시계및귀금속,227471867,4550,180639425,46832442
3,발달상권,왕십리역(왕십리),가구,360000000,1182,319590205,40409795
3,발달상권,북촌(안국역),시계및귀금속,189605123,462,186137944,3467179
3,발달상권,선정릉역,가구,78886793,45,78886793,0
3,발달상권,남부터미널역,가전제품,1769130298,8976,1458600246,310530052
3,발달상권,방배동가구거리(사당동가구거리),가구,2680472108,2976,1131048108,1549424000
3,전통시장,독산동 우시장,시계및귀금속,1014084,16,1014084,0
3,전통시장,쌍문시장(쌍문역골목시장),시계및귀금속,11901484,73,11776779,124705
3,전통시장,"동원전통종합시장(동원시장, 동원전통시장 상점가)",시계및귀금속,99059555,227,80057213,19002342
3,전통시장,답십리현대시장,가구,6937202,77,3773838,3163364
3,전통시장,전곡시장,가전제품,91609213,397,44093400,47515813
3,전통시장,삼익패션타운(남대문시장),시계및귀금속,10652960,11,10652960,0
3,전통시장,신영시장,시계및귀금속,46553444,410,29757560,16795884
2,발달상권,"신촌역(신촌역, 신촌로터리)",시계및귀금속,619419178,1780,608944344,10474834
2,골목상권,서울대입구역 8번,시계및귀금속,3561644,36,3561644,0
2,골목상권,그라운드 고척,시계및귀금속,904923,21,904923,0
2,골목상권,시흥동 은행나무사거리,시계및귀금속,21473575,107,7800001,13673574
2,발달상권,공릉역,시계및귀금속,52013554,70,46495891,5517663
2,전통시장,전곡시장,가구,36238566,169,27140373,9098193
2,전통시장,방신전통시장,시계및귀금속,8372336,60,3245401,5126935
2,발달상권,양재화물트럭터미널앞,시계및귀금속,303183,15,303183,0
2,골목상권,신정역 5번,시계및귀금속,4644020,93,4644020,0
2,발달상권,은마아파트,가구,95752548,45,95752548,0
2,골목상권,독산동정훈단지,가구,23049984,60,19401242,3648742
2,골목상권,종암동주민센터,시계및귀금속,30878125,256,30878125,0
2,골목상권,방학역 1번,시계및귀금속,19131975,101,14234100,4897875
2,발달상권,삼각지역,부동산중개업,7700000,18,7700000,0
2,골목상권,방이역 1번,가구,34027508,38,15972095,18055413
2,전통시장,새마을시장,시계및귀금속,13508411,194,9907009,3601402
2,발달상권,강서구청,시계및귀금속,2048023,40,2048023,0
2,전통시장,용산용문시장,가구,67000000,12,67000000,0
2,골목상권,새남터성지,가전제품,422158294,384,422158294,0
2,발달상권,서울남부지방법원,가전제품,298867645,509,217269691,81597954
2,발달상권,등촌역,부동산중개업,641972,96,641972,0
2,발달상권,강변역(테크노마트),가구,1223916924,1633,669145599,554771325
2,골목상권,창신역 1번,시계및귀금속,545293,11,545293,0
2,골목상권,신월3동주민센터,가구,6727521,49,6727521,0
2,골목상권,이태원엔틱가구거리,가구,175081471,417,126899177,48182294
2,전통시장,백학시장,가전제품,35923319,517,32475529,3447790
2,전통시장,제일시장,가구,934422131,1768,614023734,320398397
2,전통시장,"황학시장(서울중앙시장, 신중앙시장)",시계및귀금속,79716399,296,56300862,23415537
2,골목상권,광운대역 1번,시계및귀금속,7117058,116,5609933,1507125
2,전통시장,남대문시장(자유상가),가전제품,90467714,944,80072345,10395369
2,골목상권,광진정말공원,가구,1337793,27,0,1337793
2,골목상권,까치산역 1번,시계및귀금속,17890143,52,14731732,3158411
2,발달상권,서래마을카페거리(서래마을),시계및귀금속,28575972,73,28575972,0
2,발달상권,보라매역,시계및귀금속,2813349,136,2757083,56266
2,전통시장,행당시장상점가,가구,31000000,19,30420561,579439
2,골목상권,서강대역 1번,가전제품,289859,9,0,289859
2,전통시장,왕십리도선동상점가,시계및귀금속,46780568,126,36053827,10726741
2,골목상권,개봉1동주민센터,가전제품,25199446,91,0,25199446
2,골목상권,홍릉시장,시계및귀금속,478383,17,478383,0
2,발달상권,상계백병원,시계및귀금속,1009785,110,1009785,0
2,골목상권,석촌중학교(방이육교),가전제품,376955047,6765,316138989,60816058
2,골목상권,성자초등학교,가구,14167271,28,14167271,0
2,전통시장,신곡종합시장(신월6동 골목시장),시계및귀금속,51162865,373,37851796,13311069
2,발달상권,언주역(차병원),가구,171000000,8,171000000,0
2,골목상권,노량진초등학교,가구,43935716,147,15488130,28447586
2,전통시장,충신시장,시계및귀금속,46000000,45,46000000,0
2,전통시장,망원시장,시계및귀금속,57378740,211,40607624,16771116
2,전통시장,홍대 걷고싶은 거리,시계및귀금속,49466125,453,34177109,15289016
2,전통시장,마천중앙시장,가전제품,74019527,477,53614724,20404803
2,골목상권,관악구 중앙길,가구,10969194,21,9547393,1421801
2,전통시장,용산용문시장,시계및귀금속,17517487,32,17517487,0
2,전통시장,월정로시장,가구,13068103,143,12007758,1060345
2,전통시장,도곡시장,시계및귀금속,390433350,687,378846968,11586382
2,전통시장,상도도깨비 골목형상점가,시계및귀금속,9030928,68,9030928,0
2,전통시장,영등포시장기계공구상가,가구,8856357,89,0,8856357
2,전통시장,미성동 도깨비시장 골목형상점가,시계및귀금속,9919622,67,9919622,0
2,골목상권,방배아이파크아파트,가구,3687916282,4763,2545916813,1141999469
2,전통시장,남구로시장,가구,30097300,117,24330405,5766895
2,전통시장,사당시장,가전제품,1813763425,1334,1405489023,408274402
2,전통시장,사당1동먹자골목상점가(사당1동먹자골목),부동산중개업,21805981,254,7268660,14537321
2,골목상권,신월2동주민센터,시계및귀금속,47383288,899,33371603,14011685
2,전통시장,도곡시장,가구,42403002,136,26840486,15562516
2,관광특구,동대문패션타운 관광특구,가구,3521114713,8634,3498667982,22446731
2,골목상권,영신초등학교,시계및귀금속,83808902,153,76724516,7084386
2,관광특구,잠실 관광특구,가구,27211753,47,661397,26550356
2,골목상권,삼전역 1번,가구,68748133,141,67337915,1410218
2,골목상권,문성초등학교,시계및귀금속,30549032,79,17884270,12664762
2,관광특구,강남 마이스 관광특구,가구,8761157030,5252,3918193202,4842963828
2,골목상권,방배역 3번,가구,724382048,123,724382048,0
2,골목상권,신림역 8번,가구,1698073158,3375,1102802679,595270479
2,골목상권,신림현대아파트,가전제품,12402822,85,8589864,3812958
2,골목상권,창덕궁,시계및귀금속,2221000000,4144,1031850444,1189149556
2,골목상권,신정네거리역 2번,가구,49152038,100,45413200,3738838
2,골목상권,시흥초등학교(시흥1동우체국),시계및귀금속,14927258,35,14674682,252576
2,발달상권,마들역,시계및귀금속,25373539,483,23957799,1415740
2,골목상권,우장산역 4번,시계및귀금속,42886491,532,23738272,19148219
2,발달상권,"강남구청(청담역_8번, 강남세무서)",가구,4480905418,1436,3005449047,1475456371
2,골목상권,시흥초등학교(시흥1동우체국),가구,21605840,81,7240875,14364965
2,골목상권,암사역 2번(서울강동초등학교),시계및귀금속,3862051,34,3862051,0
2,골목상권,양지어린이공원,시계및귀금속,19468528,114,17682918,1785610
2,골목상권,서울지방병무청,가구,28771723,130,18963181,9808542
2,골목상권,푸른들청소년도서관,시계및귀금속,46638842,181,17026305,29612537
2,발달상권,오금역,가전제품,153278,10,153278,0
2,골목상권,금천구립가산도서관,시계및귀금속,3703253,76,3703253,0
2,발달상권,미아사거리역,시계및귀금속,428169446,10582,306728192,121441254
2,골목상권,방학중학교,시계및귀금속,20960134,57,20187458,772676
2,골목상권,상계초등학교,시계및귀금속,9232562,72,4742590,4489972
2,골목상권,수락산디자인거리,가구,59365930,234,42373817,16992113
2,발달상권,도곡1동,가전제품,14000000,10,12849765,1150235
2,발달상권,한성대입구역,가구,36518385,49,36518385,0
2,발달상권,롯데백화점(시청광장 지하쇼핑센터),시계및귀금속,7970086530,3919,6202133296,1767953234
2,발달상권,신정네거리역,가구,1176795099,1047,543740179,633054920
2,발달상권,영등포역(영등포),시계및귀금속,9231184199,81585,5084613968,4146570231
2,발달상권,신용산역(용산역),시계및귀금속,74077083,377,73753388,323695
2,골목상권,먹골역 1번,가구,177893456,242,115400476,62492980
2,발달상권,종로3가역,가구,208000000,27,0,208000000
2,발달상권,길동역,가구,10447935,309,9245462,1202473
2,골목상권,숭곡초등학교,시계및귀금속,44401247,110,38854603,5546644
2,발달상권,삼청동,시계및귀금속,39504840,731,17206670,22298170
2,골목상권,외대앞역 1번,가구,1144615,9,1144615,0
2,골목상권,서울여자간호대학교,시계및귀금속,3447917,20,3447917,0
2,발달상권,동대문역사문화공원역,시계및귀금속,54531809,315,54531809,0
2,골목상권,은평세무서,가구,112251976,437,87422297,24829679
2,발달상권,목동신시가지,시계및귀금속,269396910,2579,159330862,110066048
2,발달상권,명일역,시계및귀금속,65133492,692,57175737,7957755
2,발달상권,아차산역,가전제품,629118667,1886,359189109,269929558
2,골목상권,상봉역 4번,가구,117815793,230,99644349,18171444
2,발달상권,목동사거리,가구,255595814,583,159422865,96172949
2,골목상권,경신고등학교,시계및귀금속,15104536,209,15006130,98406
2,골목상권,아차산역 5번,가구,3922882767,3878,2394644759,1528238008
2,골목상권,신내1동주민센터,시계및귀금속,46336278,156,46216500,119778
2,골목상권,러스크서울병원,시계및귀금속,9836207,60,9106583,729624
2,발달상권,신도림역,가전제품,1919541402,6082,1403986530,515554872
2,발달상권,뱅뱅사거리,시계및귀금속,49149680,241,34519313,14630367
2,발달상권,구역삼세무서,가구,304413052,258,91120604,213292448
2,발달상권,대치사거리,가구,2095449894,3214,1546006999,549442895
2,골목상권,사근동살곶이상점가,시계및귀금속,3587940,422,3165830,422110
2,전통시장,장미원골목시장,시계및귀금속,28137564,63,17228473,10909091
2,골목상권,자양4동주민센터,가구,19159086,115,17721795,1437291
2,전통시장,영천시장,시계및귀금속,73443479,299,69501904,3941575
2,골목상권,황학코아루아파트,시계및귀금속,8826727,28,8011325,815402
2,전통시장,창동역상점가,시계및귀금속,33417887,234,14985366,18432521
2,전통시장,강북종합전통시장(강북종합골목시장),시계및귀금속,20215801,121,17276940,2938861
2,골목상권,성원중학교,가전제품,204883359,589,200390303,4493056
2,골목상권,공항시장역 3번,시계및귀금속,23627672,96,15567877,8059795
2,골목상권,연희임광아파트,가구,328000000,78,328000000,0
2,발달상권,"총신대입구역(이수, 총신대)",가구,1928027701,1166,1921773253,6254448
2,발달상권,구로전화국,가구,137630282,1488,135322520,2307762
2,발달상권,서울대입구역,가전제품,2435128844,7590,1485261333,949867511
2,발달상권,석촌고분역,시계및귀금속,9205137,108,8101353,1103784
2,발달상권,잠실역,시계및귀금속,423994078,2515,121087663,302906415
2,발달상권,남부터미널역,시계및귀금속,42621115,1893,37859145,4761970
2,전통시장,대명여울빛거리시장(대명시장),시계및귀금속,21000000,175,12501767,8498233
2,전통시장,남문시장,시계및귀금속,10793578,60,7513762,3279816
2,전통시장,은행나무시장,시계및귀금속,368983,25,368983,0
2,전통시장,강북북부골목시장,시계및귀금속,1667546,77,1010215,657331
2,골목상권,암사역 2번(서울강동초등학교),가전제품,3083538568,1875,1891196463,1192342105
2,전통시장,충신시장,가전제품,8240378,199,8240378,0
2,전통시장,제일시장,시계및귀금속,795375291,3393,454681776,340693515
2,전통시장,뚝섬역상점가,시계및귀금속,15604736,139,12333521,3271215
2,골목상권,화곡초등학교,시계및귀금속,10348273,131,7832045,2516228
2,전통시장,답십리현대시장,가구,9989571,111,8935116,1054455
2,전통시장,광장시장(광장전통시장),시계및귀금속,602632182,970,437546475,165085707
2,골목상권,성동구보건소,가전제품,12756757,383,6378378,6378379
2,골목상권,동묘앞역 2번,시계및귀금속,5905988,56,5905988,0
2,전통시장,대림상가(청계상가),가전제품,1171390396,11084,1147172743,24217653
2,골목상권,강서고등학교,시계및귀금속,35589955,88,24826982,10762973
2,골목상권,모래내우체국,가전제품,6650618218,3510,4162042097,2488576121
2,골목상권,명지대학교,시계및귀금속,2498612,67,2498612,0
2,골목상권,면목역 3번,시계및귀금속,7726563,28,7546875,179688
2,전통시장,목동깨비시장(목3동시장),가구,106233989,340,84555899,21678090
2,골목상권,태릉시장 특화거리,가전제품,44531184,174,25367764,19163420
2,골목상권,성동세무서,시계및귀금속,1846882,10,1846882,0
2,골목상권,해방촌 남동측,시계및귀금속,16655435,96,16344566,310869
2,전통시장,수일시장,시계및귀금속,83581455,228,69629005,13952450
2,전통시장,고척근린시장,시계및귀금속,9366285,88,1383096,7983189
2,골목상권,장안제일시장,시계및귀금속,2215384,24,2215384,0
2,전통시장,엔터식스 강남점,시계및귀금속,10664236,18,7231796,3432440
2,전통시장,공덕시장,시계및귀금속,6886247,295,6733446,152801
2,골목상권,장승배기역 5번,가구,14306166,87,11776603,2529563
2,골목상권,신대방역 3번,부동산중개업,1126151,140,633460,492691
2,골목상권,장훈고등학교,시계및귀금속,15326763,93,15326763,0
2,전통시장,문정동 로데오거리 상점가(문정동 로데오거리),시계및귀금속,9245966,114,9030818,215148
2,전통시장,서서울 골목형상점가,가전제품,124286652,328,84175139,40111513
2,전통시장,신원시장,시계및귀금속,5863550,24,6,5863544
2,전통시장,까치산시장,가전제품,9715517,287,8895843,819674
2,골목상권,남구로역 3번,가전제품,3857585,86,3571517,286068
2,관광특구,잠실 관광특구,시계및귀금속,463748286,2498,165755212,297993074
2,골목상권,봉천역 4번(봉천110안전센터),가구,100662371,332,50678244,49984127
2,골목상권,용두동신동아아파트,시계및귀금속,61397939,126,56302475,5095464
2,골목상권,난우초등학교,가구,38332721,153,28622277,9710444
2,골목상권,선일여고,시계및귀금속,1319151,24,1319151,0
2,골목상권,관악해태어린이공원,부동산중개업,870000000,9586,740621591,129378409
2,골목상권,서강대학교,가전제품,705045303,1549,460379781,244665522
2,골목상권,문성초등학교,가구,115335368,357,72596091,42739277
2,골목상권,거여역 1번(거여공원),가전제품,107150654,711,101591443,5559211
2,골목상권,논현초등학교,가전제품,49280000,23,49280000,0
2,골목상권,마천역(마천초등학교),가구,100652113,506,64468802,36183311
2,골목상권,NH농협은행 상도동지점,시계및귀금속,43808949,282,38388761,5420188
2,골목상권,개봉1동주민센터,시계및귀금속,33955070,106,30161506,3793564
2,골목상권,서초중학교,시계및귀금속,27205811,398,27205811,0
2,골목상권,신림역 8번,가전제품,4637411360,2011,3065071966,1572339394
2,발달상권,양재화물트럭터미널앞,가구,23917247,76,23917247,0
2,발달상권,양재화물트럭터미널앞,가전제품,724403447,557,222950535,501452912
2,골목상권,포이초등학교(개포목련어린이공원),가전제품,188389801,646,125593200,62796601
2,발달상권,구파발역,시계및귀금속,518365244,539,402879543,115485701
2,골목상권,원신초등학교(구세군관악영문교회),가전제품,58357676,310,58357676,0
2,골목상권,인헌고등학교(인헌중학교),시계및귀금속,25007097,473,15066005,9941092
2,골목상권,도봉산입구,시계및귀금속,40329901,277,38787876,1542025
2,발달상권,종로3가역,시계및귀금속,1.88E+11,343040,1.49E+11,38707887198
2,발달상권,장지역(가든파이브),가구,2105891405,2727,1354682298,751209107
2,골목상권,수락산디자인거리,시계및귀금속,9928501,51,9014696,913805
2,발달상권,양재역,시계및귀금속,218926136,1009,205964979,12961157
2,발달상권,학동역,가구,9829836302,14992,6601327896,3228508406
2,골목상권,상계역,시계및귀금속,1538462,76,1538462,0
2,골목상권,경춘선숲길 우측,시계및귀금속,11481372,64,5203603,6277769
2,발달상권,강남을지병원,가구,542070422,324,359986048,182084374
2,골목상권,수락산역 4번,가구,7040333,25,7040333,0
2,발달상권,연신내역,가전제품,96428020,978,76500848,19927172
2,발달상권,도산공원교차로,가구,1933742211,1185,1139081517,794660694
2,골목상권,석관중앙교회,가구,8534425,68,6773353,1761072
2,골목상권,갈현건영아파트,시계및귀금속,5875161,396,5393823,481338
2,발달상권,강변역(테크노마트),시계및귀금속,358664784,3275,231533401,127131383
2,발달상권,가로수길,시계및귀금속,216151326,2070,93238734,122912592
2,발달상권,신설동역,가전제품,52609706,197,47097744,5511962
2,골목상권,중암중학교,가전제품,122971,18,122971,0
2,발달상권,을지로3가역,가구,86859747,2034,60220227,26639520
2,발달상권,뚝섬역,가구,1170748557,570,1170748557,0
2,발달상권,합정역,가전제품,19477169,127,7001597,12475572
2,발달상권,등촌역,가구,3601060971,3594,2209476068,1391584903
2,발달상권,구의역,시계및귀금속,37339367,333,36751132,588235
2,발달상권,마포역,시계및귀금속,4122011,453,3870669,251342
2,발달상권,오목교역,시계및귀금속,998172215,832,998002903,169312
2,골목상권,상월곡역 1번,시계및귀금속,2353234,20,2353234,0
2,골목상권,보문역 4번,가구,185327677,409,117911299,67416378
2,발달상권,고속터미널(고속터미널역),시계및귀금속,14162405360,27680,10499898832,3662506528
2,발달상권,신논현역,가구,760633373,1801,760633373,0
2,발달상권,선릉역,시계및귀금속,2861608,14,2410961,450647
2,골목상권,양천향교역 5번,가구,596912644,800,596912644,0
2,발달상권,학동역,시계및귀금속,13469634,321,10788301,2681333
2,발달상권,학동사거리,시계및귀금속,5537137084,2931,5274777038,262360046
2,전통시장,청량리수산시장,가구,469133728,828,376483492,92650236
2,골목상권,영신초등학교,가전제품,522368113,2494,517949561,4418552
2,전통시장,"수유전통시장(수유시장, 수유골목시장)",시계및귀금속,139429448,304,109544089,29885359
2,골목상권,동교초등학교,시계및귀금속,34744644,230,34258251,486393
2,발달상권,문정역,가구,2153864152,800,1927991701,225872451
2,발달상권,신당역,부동산중개업,29000000,64,0,29000000
2,발달상권,대림3동사거리,시계및귀금속,24408215,51,22889732,1518483
2,발달상권,장지역(가든파이브),시계및귀금속,178498511,4283,143708696,34789815
2,발달상권,선정릉역,가구,5330189,30,5330189,0
2,골목상권,금호삼성래미안아파트,시계및귀금속,16797772,9,15000000,1797772
2,발달상권,대치사거리,부동산중개업,195000000,26157,145708470,49291530
2,골목상권,화곡역 4번,가구,96720781,1124,91801584,4919197
2,발달상권,성수대교남단,시계및귀금속,433101632,2479,433101632,0
2,골목상권,청담초등학교,시계및귀금속,3290328936,3216,1464433908,1825895028
2,전통시장,뚝도시장,시계및귀금속,121044120,333,120892512,151608
2,전통시장,관악중부시장,시계및귀금속,21618084,165,11373951,10244133
2,전통시장,독산동 맛나는거리상점가(독산동 맛나는거리),시계및귀금속,12964611,68,11599915,1364696
2,골목상권,달마을공원,시계및귀금속,28586763,224,21515773,7070990
2,전통시장,정릉시장,시계및귀금속,9749406,217,9523446,225960
2,골목상권,화원중학교,시계및귀금속,11768410,46,8760491,3007919
2,골목상권,신월1파출소,시계및귀금속,18507462,44,1343283,17164179
2,골목상권,굽은다리역 3번,부동산중개업,290778,55,290778,0
2,전통시장,응암오거리상점가,시계및귀금속,6628158,57,5776172,851986
2,전통시장,연희사러가,시계및귀금속,3014151,70,2944054,70097
2,골목상권,해오름공원,시계및귀금속,25736932,180,21801401,3935531
2,전통시장,고덕 골목형상점가,시계및귀금속,22721024,339,14458833,8262191
2,전통시장,길동복조리시장,시계및귀금속,120400748,505,98985815,21414933
2,골목상권,체부동홍종문가옥,시계및귀금속,19015769,120,19015769,0
2,전통시장,영등포유통상가,가전제품,334647695,1216,186850189,147797506
2,전통시장,목2동시장,시계및귀금속,28589660,130,28071474,518186
2,골목상권,강동역 4번(강풀만화거리),가전제품,9344430,70,9344430,0
2,골목상권,아현역 2번,가전제품,11181471,620,7570603,3610868
2,전통시장,신정1동 골목시장(신정제일시장),시계및귀금속,7720207,77,7655797,64410
2,골목상권,신풍역 1번,시계및귀금속,10918919,54,10918919,0
2,전통시장,소공지하도상가,시계및귀금속,478597337,4275,465494528,13102809
2,전통시장,신영시장,가구,37407256,190,31721269,5685987
2,전통시장,방이시장,시계및귀금속,56117767,354,48051250,8066517
2,전통시장,신노량진시장(기능상실),시계및귀금속,3021027,63,2883708,137319
2,전통시장,대림중앙 골목형상점가,부동산중개업,12934479,706,9406894,3527585
2,전통시장,신림중앙시장(조원동 펭귄시장),시계및귀금속,9465889,38,7661580,1804309
2,골목상권,묘곡초등학교(고덕아이파크아파트),시계및귀금속,5362886,93,3342684,2020202
2,관광특구,명동 남대문 북창동 다동 무교동 관광특구,가구,25823781,212,25005422,818359
2,관광특구,강남 마이스 관광특구,시계및귀금속,1173482541,982,1038405986,135076555
2,골목상권,푸른동산공원,시계및귀금속,26532787,108,26504787,28000
2,골목상권,영신여고,시계및귀금속,306581,48,117916,188665
2,골목상권,문정초등학교,시계및귀금속,3096053,10,3096053,0
2,골목상권,우리은행응암동지점,시계및귀금속,29869012,615,27833809,2035203
2,골목상권,공릉역 2번,시계및귀금속,13634684,138,12264962,1369722
2,골목상권,헌인가구단지,가구,309758159,514,135124120,174634039
2,골목상권,은천초등학교(은천교앞),시계및귀금속,27882919,776,27882919,0
2,골목상권,관악구신사동주민센터,가구,5522124,69,2300885,3221239
2,골목상권,사당역 10번,시계및귀금속,109710826,297,85971234,23739592
2,골목상권,송파나루역 3번,가구,13704976,30,13704976,0
2,골목상권,성자초등학교,시계및귀금속,113307468,384,113307468,0
2,골목상권,남구로역 5번,가전제품,10986440,98,8351012,2635428
2,골목상권,신월시영아파트중문,가구,102031612,276,57515889,44515723
2,발달상권,포이사거리(삼호물산),가전제품,288811190,541,288811190,0
2,골목상권,영서중학교,시계및귀금속,31701808,36,31657581,44227
2,골목상권,문성초등학교,가전제품,397071422,3416,311297544,85773878
2,골목상권,신월3동주민센터,가전제품,115989113,638,85752314,30236799
2,발달상권,연희동,시계및귀금속,8795890,65,7696314,1099576
2,골목상권,상계2동주민센터,가구,16732055,53,14592797,2139258
2,발달상권,용산전자상가(용산역),가전제품,1.84E+11,426252,1.11E+11,72666711401
2,발달상권,서울대입구역,가구,122466105,509,76960778,45505327
2,골목상권,행당역 2번,시계및귀금속,35368761,196,26206330,9162431
2,골목상권,구립대학경로당(관악산샘말공원),부동산중개업,653563,32,653563,0
2,발달상권,장지역(가든파이브),가전제품,203057289,1156,177487496,25569793
2,골목상권,도봉구보건소,시계및귀금속,38623715,711,35117908,3505807
2,발달상권,금호역,시계및귀금속,47133202,362,41695521,5437681
2,발달상권,장안동사거리,시계및귀금속,14252945,720,9593843,4659102
2,발달상권,오금역,시계및귀금속,5160164,89,4782759,377405
2,골목상권,수락산역 4번,가전제품,117000000,339,63584898,53415102
2,발달상권,도곡1동,가구,306204481,341,131250018,174954463
2,골목상권,수유역 2번,가구,95131264,67,95131264,0
2,발달상권,공릉역,가전제품,1689677341,3757,987245636,702431705
2,발달상권,성신여대,시계및귀금속,150742939,1250,107270647,43472292
2,골목상권,4.19민주묘지역 2번,시계및귀금속,62761724,292,56640051,6121673
2,발달상권,성신여대,가구,73086304,248,57673546,15412758
2,발달상권,한성대입구역,시계및귀금속,11893108,337,9059493,2833615
2,골목상권,돌곶이역 5번,가전제품,62878645,176,30760928,32117717
2,골목상권,장스여성병원,시계및귀금속,40084665,257,32700930,7383735
2,발달상권,이태원(이태원역),시계및귀금속,509662927,1856,415504407,94158520
2,발달상권,학동사거리,가구,51837257,833,51144800,692457
2,골목상권,망우역 1번,가전제품,4104908787,9782,2075972169,2028936618
2,골목상권,장안중학교,시계및귀금속,53719779,187,50472588,3247191
2,골목상권,서일대학교,시계및귀금속,76999930,297,65952844,11047086
2,골목상권,응암동우체국,가구,56939794,106,55785609,1154185
2,발달상권,노량진역(노량진),가구,573120554,773,323975058,249145496
2,골목상권,중화역 4번,가구,76967297,192,73334637,3632660
2,발달상권,영등포역(영등포),가전제품,242199238,1165,151855381,90343857
2,골목상권,연신내역 3번,가구,318955322,874,212220762,106734560
2,발달상권,신설동역,시계및귀금속,35758463,320,27707383,8051080
2,발달상권,종로4가,시계및귀금속,15919859318,21002,12121266810,3798592508
2,발달상권,아차산역,가구,4229276931,1550,4098519944,130756987
2,발달상권,상봉역,가전제품,1182358815,2799,829407731,352951084
2,발달상권,서촌(경복궁역),시계및귀금속,51319958,23,51319958,0
2,발달상권,약수역,시계및귀금속,135545076,717,97192808,38352268
2,발달상권,충무로역,시계및귀금속,38743833,167,38743833,0
2,발달상권,건대입구역(건대),시계및귀금속,571372591,3877,292207338,279165253
2,발달상권,인사동,가전제품,60155940,105,23249176,36906764
2,발달상권,종각역,시계및귀금속,1456557019,9913,931708116,524848903
2,발달상권,고덕역,가구,21933595,86,21933595,0
2,발달상권,성수역,시계및귀금속,6492622,21,4057889,2434733
2,발달상권,목동사거리,가전제품,4521733203,9069,2383516887,2138216316
2,골목상권,등촌3동주민센터,시계및귀금속,62476116,511,55805945,6670171
2,발달상권,화곡역,가전제품,240698957,2511,212497605,28201352
2,골목상권,장안근린공원,시계및귀금속,28143374,116,26034466,2108908
2,발달상권,논현역,시계및귀금속,110796015,208,94746155,16049860
2,발달상권,대치역,시계및귀금속,53592121,460,50340676,3251445
2,발달상권,개나리아파트,가구,646218599,376,430469942,215748657
2,골목상권,서울역 15번,가구,58575422,152,52395968,6179454
2,골목상권,충정로역 7번,가구,70689153,150,49091588,21597565
2,발달상권,신대방삼거리역,시계및귀금속,23386023,415,16730449,6655574
2,골목상권,공항시장역 1번,가구,67324074,327,43754814,23569260
2,발달상권,신도림역,시계및귀금속,533218435,2203,381009596,152208839
2,골목상권,공항시장역 1번,시계및귀금속,68218416,300,30587730,37630686
2,발달상권,교대역(법원.검찰청),부동산중개업,481818,96,481818,0
2,발달상권,가산디지털단지,가전제품,1473223779,6651,1439101956,34121823
2,발달상권,"총신대입구역(이수, 총신대)",시계및귀금속,772986622,1275,589479329,183507293
2,골목상권,중곡역 3번,시계및귀금속,15700862,85,11119832,4581030
2,전통시장,영등포역지하도상점가,시계및귀금속,3567776607,4967,1615509112,1952267495
2,골목상권,등촌3동주민센터,가구,262150187,331,100596521,161553666
2,전통시장,비단길현대시장(현대시장),시계및귀금속,134415929,317,113531594,20884335
2,전통시장,방학동도깨비시장,시계및귀금속,125748545,534,66986903,58761642
2,전통시장,삼양골목시장(삼양시장),시계및귀금속,19010843,37,19010843,0
2,전통시장,우림골목시장,가전제품,10561668,165,8337291,2224377
2,골목상권,곰달래도서관,시계및귀금속,68016165,210,46196728,21819437
2,발달상권,강남구청역,시계및귀금속,224431688,158,79760039,144671649
2,발달상권,가산디지털단지,가구,241797979,1149,237377379,4420600
2,골목상권,길동주민센터(강동도서관),시계및귀금속,30492906,176,28192422,2300484
2,골목상권,화곡역 4번,시계및귀금속,37698713,140,37045791,652922
2,발달상권,삼성역,가전제품,15623999,130,15623999,0
2,골목상권,화곡2동주민센터,가구,33539212,48,13620384,19918828
2,발달상권,역삼역,시계및귀금속,1668562,38,926979,741583
2,발달상권,남부터미널역,가전제품,2144076361,8448,2090979352,53097009
2,발달상권,석촌고분역,가구,429915165,296,259313909,170601256
2,발달상권,삼성중앙역,가구,358764574,491,36184698,322579876
2,전통시장,남대문시장(자유상가),시계및귀금속,2759673354,87820,2054639937,705033417
2,골목상권,신방화역 2번,시계및귀금속,236455481,445,183338026,53117455
2,전통시장,황학동주방가구거리상점가,가구,5904924204,10491,4531614889,1373309315
2,골목상권,자양4동주민센터,시계및귀금속,600000,68,480000,120000
2,전통시장,밤나무골시장,시계및귀금속,1889383,24,1528627,360756
2,골목상권,동대부고,가전제품,1280830080,2970,689052132,591777948
2,전통시장,수유프라자,가구,107574879,316,49608158,57966721
2,전통시장,신아타운,시계및귀금속,23559469,100,20941058,2618411
2,골목상권,명지대학교교회,시계및귀금속,4252747,60,3379121,873626
2,전통시장,전곡시장,시계및귀금속,5794576,53,3734283,2060293
2,골목상권,망리단길,가전제품,150931772,297,141726964,9204808
2,전통시장,송화벽화시장(송화골목시장),시계및귀금속,7957355,220,5963485,1993870
2,전통시장,전곡시장,가전제품,112581435,557,112581435,0
2,전통시장,황학동주방가구거리상점가,가전제품,494482256,1042,489183927,5298329
2,전통시장,고척근린시장,가구,313227452,826,270135110,43092342
2,전통시장,망원월드컵시장,가구,33159211,137,27940453,5218758
2,전통시장,암사종합시장,시계및귀금속,8637290,72,6900283,1737007
2,전통시장,고분다리전통시장,시계및귀금속,28156425,43,17660614,10495811
2,골목상권,영등포역 2번,부동산중개업,26915888,3139,21196262,5719626
2,발달상권,사당역(사당),시계및귀금속,23111061,479,19165340,3945721
2,전통시장,중부시장(신중부시장),가구,5700472392,193935,4849871848,850600544
2,발달상권,등나무근린공원,시계및귀금속,229523634,861,161436493,68087141
2,발달상권,논현역 5번,가구,2076000000,1949,1205139911,870860089
2,골목상권,상도역 5번,가전제품,10729613,22,10729613,0
2,발달상권,군자역,가구,5459157832,6338,2699779491,2759378341
2,골목상권,두산초등학교,가구,111681351,150,0,111681351
2,발달상권,신림역(신림),시계및귀금속,145425830,1986,81247804,64178026
2,발달상권,논현역,가전제품,7037130991,4134,4290169315,2746961676
2,발달상권,여의도역(여의도),부동산중개업,15521375,235,15521375,0
2,전통시장,수유프라자,시계및귀금속,97645403,515,66780476,30864927
2,발달상권,청량리역(청량리),시계및귀금속,36187225,188,35190648,996577
2,골목상권,구반포역,가전제품,31996490,544,30637828,1358662
2,골목상권,신대방역 4번,시계및귀금속,1318801,28,1262200,56601
2,골목상권,강동구립성내도서관,시계및귀금속,807552,5,0,807552
2,골목상권,봉천역 6번,시계및귀금속,46441627,38,44268191,2173436
2,발달상권,청담사거리(청담동명품거리),가구,11714245731,3499,8335230756,3379014975
2,골목상권,먹골역 5번,가구,116879681,568,90258387,26621294
2,발달상권,구로전화국,가전제품,1101623180,2843,729308820,372314360
2,발달상권,사가정역,시계및귀금속,15864795,90,13781279,2083516
2,골목상권,송파책박물관,가전제품,14652394,116,14652394,0
2,발달상권,구로전화국,시계및귀금속,245557929,442,245557929,0
2,골목상권,금천구청역 1번 출입구,시계및귀금속,16960501,239,16597809,362692
2,골목상권,남구로역 2번,시계및귀금속,47994739,247,7269907,40724832
2,골목상권,선정중학교,가구,9412421,28,9412421,0
2,발달상권,삼청동,가구,59198471,118,59198471,0
2,골목상권,구로디지털단지역 4번,가구,24766024,96,15808101,8957923
2,발달상권,을지로4가역,시계및귀금속,6537753,152,5448127,1089626
2,골목상권,도봉역 2번,가전제품,103200000,1371,103200000,0
2,발달상권,청담사거리(청담동명품거리),시계및귀금속,2191845472,3205,1319789422,872056050
2,발달상권,서교동(홍대),시계및귀금속,42074457,277,40237077,1837380
2,전통시장,사가정시장,시계및귀금속,15852414,114,9246700,6605714
2,전통시장,관악신사시장,가구,50893046,227,42363485,8529561
2,발달상권,충무로역,부동산중개업,379943818,40414,332382109,47561709
2,발달상권,미아사거리역,가전제품,558590314,8963,453405676,105184638
2,발달상권,미아사거리,가전제품,40475916,233,23120775,17355141
2,골목상권,하나고등학교,가구,2000000,6,2000000,0
2,발달상권,대학로(혜화역),시계및귀금속,41862151,487,34328596,7533555
2,전통시장,독산동 우시장,시계및귀금속,8830986,33,8830986,0
2,발달상권,서대문역,시계및귀금속,20443726,77,20443726,0
2,발달상권,한남오거리,시계및귀금속,19075934,100,19075934,0
2,골목상권,남천초등학교,시계및귀금속,36412480,87,33448485,2963995
2,골목상권,언주역 6번,가구,87512586,54,87512586,0
2,골목상권,구로초등학교,시계및귀금속,5030953,32,3105527,1925426
2,골목상권,신대방삼거리역 3번,가구,35292022,65,23518203,11773819
2,골목상권,서문여고,가구,7159242,163,7159242,0
2,발달상권,석촌역(석촌호수),가구,509263906,476,240178641,269085265
2,발달상권,서울세관,가구,252754004,153,252754004,0
2,전통시장,삼익패션타운(남대문시장),시계및귀금속,4225600,11,4225600,0
2,발달상권,종로구청,시계및귀금속,2948769842,2308,2852709644,96060198
2,발달상권,포스코사거리,시계및귀금속,133773550,134,133773550,0
2,발달상권,월드컵경기장역(월드컵경기장),시계및귀금속,64468144,1626,48768204,15699940
2,골목상권,아차산역 1번,가전제품,136889895,451,134525277,2364618
2,발달상권,성북구청,가전제품,84983373,767,51021506,33961867
2,발달상권,명동(명동거리),시계및귀금속,303546391,3304,254940839,48605552
2,발달상권,용산전자상가(용산역),시계및귀금속,63447138,2364,61870812,1576326
2,발달상권,천호역,가구,565117707,5731,385464906,179652801
2,발달상권,서울역,시계및귀금속,39286477,5304,37224040,2062437
2,골목상권,포이초등학교(개포목련어린이공원),가구,1038133480,651,430594250,607539230
2,발달상권,등촌역,시계및귀금속,68250991,125,68250991,0
2,골목상권,노량진역 6번,시계및귀금속,3582490,70,1583229,1999261
2,발달상권,어린이대공원역,시계및귀금속,50230692,109,41274323,8956369
2,관광특구,동대문패션타운 관광특구,부동산중개업,29000000,64,0,29000000
2,발달상권,구의사거리,가구,209206470,476,103095194,106111276
2,발달상권,목동역 8번출구,가구,58925620,140,30000001,28925619
2,발달상권,화곡역,시계및귀금속,44531533,113,21953171,22578362
2,발달상권,성수역,가전제품,42000000,53,28262435,13737565
2,발달상권,어린이대공원역,가전제품,456000125,563,382380909,73619216
2,발달상권,월곡역,시계및귀금속,36563166,198,15581063,20982103
2,발달상권,왕십리역(왕십리),시계및귀금속,645586690,5046,573409859,72176831
2,발달상권,한티역,부동산중개업,30097223,3361,27500001,2597222
2,발달상권,서래마을카페거리(서래마을),가구,599617069,1785,398191676,201425393
2,발달상권,신용산역(용산역),가구,8598000000,10166,4473237656,4124762344
2,골목상권,마천1치안센터,가전제품,122442750,255,86153054,36289696
2,발달상권,목동신시가지,가구,1324000000,569,994608969,329391031
2,전통시장,난곡 골목형상점가,시계및귀금속,24931,5,0,24931
2,골목상권,금천금빛공원(은행나무사거리서측),가구,58004435,168,37339247,20665188
2,골목상권,공릉동 국수거리,가구,160343672,163,151886321,8457351
2,골목상권,신월7동주민센터,시계및귀금속,11516084,129,7735369,3780715
2,전통시장,유진상가,시계및귀금속,30046503,172,20434377,9612126
2,발달상권,발산역(마곡),가구,160399250,37,160399250,0
2,전통시장,공릉동 도깨비시장,가구,13539474,71,5904432,7635042
2,발달상권,구로디지털단지,가전제품,8838900,117,8838900,0
2,전통시장,"수유전통시장(수유시장, 수유골목시장)",가전제품,185718603,1758,133889346,51829257
2,전통시장,강남터미널지하도상점가2구역,가구,114091038,3216,82663734,31427304
2,발달상권,가산디지털단지,시계및귀금속,145173072,1197,137892860,7280212
2,발달상권,"총신대입구역(이수, 총신대)",가전제품,512920706,1712,292910137,220010569
2,발달상권,구로디지털단지역,시계및귀금속,90003517,96,29888507,60115010
2,골목상권,응암정보도서관,가구,6664571,22,6664571,0
2,발달상권,선릉역,가구,585231818,20979,529318431,55913387
2,골목상권,목동보건지소,시계및귀금속,8256768,236,7126064,1130704
2,발달상권,사당역(사당),가구,953953396,9132,920540274,33413122
2,발달상권,강동구청역,가전제품,3328564557,2123,1693852159,1634712398
2,발달상권,노원역,가전제품,2113218583,1465,1171884425,941334158
2,전통시장,회기시장,시계및귀금속,44558167,380,32252281,12305886
2,전통시장,풍납시장,시계및귀금속,13308720,147,11088891,2219829
2,전통시장,중랑동부시장,가전제품,315034875,699,145081851,169953024
2,전통시장,방천골목시장,시계및귀금속,73865709,165,73831487,34222
2,전통시장,장위전통시장,시계및귀금속,32893040,60,27438354,5454686
2,전통시장,연희사러가,가전제품,106220887,4676,66929846,39291041
2,골목상권,삼전역 4번,시계및귀금속,19058679,167,18479583,579096
2,전통시장,인현시장,시계및귀금속,10785070,154,10527670,257400
2,발달상권,"양재시민의숲역(양재동꽃시장, aT센터)",가구,31205667,104,31205667,0
2,발달상권,신용산역(용산역),가전제품,5396208783,15457,2691135788,2705072995
2,발달상권,명일역,가구,16805727,116,8683655,8122072
2,발달상권,굽은다리역,시계및귀금속,59972554,143,52727971,7244583
2,전통시장,목동깨비시장(목3동시장),시계및귀금속,1464688,21,1421767,42921
2,발달상권,방배동가구거리(사당동가구거리),가구,2774612581,3013,1399055892,1375556689
2,발달상권,인사동,시계및귀금속,336250114,8496,98201175,238048939
2,전통시장,종로신진시장,시계및귀금속,63584296,295,63584296,0
2,전통시장,세운상가가동,시계및귀금속,261000000,1482,152643770,108356230
2,전통시장,아현가구거리상점가,가구,4074460494,5040,2480634914,1593825580
2,전통시장,화곡본동시장,가구,2979275,10,2979275,0
2,전통시장,성내전통시장,시계및귀금속,4628099,55,4242424,385675
2,전통시장,도림시장,시계및귀금속,26555292,123,26555292,0
2,전통시장,"동원전통종합시장(동원시장, 동원전통시장 상점가)",가구,322274006,1025,199288178,122985828
2,골목상권,내를건너서숲으로도서관,가전제품,3606207,87,3606207,0
2,골목상권,장안1동주민센터,가전제품,254911756,950,207400455,47511301
2,골목상권,뜸부기어린이공원,가구,278699467,1310,220227752,58471715
2,전통시장,석촌시장,가구,833772,8,833772,0
2,골목상권,암사역 1번,시계및귀금속,56396476,258,48480048,7916428
2,골목상권,언주역 3번,가구,33987426,78,33987426,0
2,골목상권,창2동주민센터,시계및귀금속,7729071,24,7729071,0
2,전통시장,대조시장,시계및귀금속,46055410,64,35121048,10934362
2,전통시장,금남시장,시계및귀금속,145755726,343,122282885,23472841
2,전통시장,불광먹자골목 골목형상점가,시계및귀금속,47056654,302,42775729,4280925
2,발달상권,종로4가,가전제품,95842267,288,95842267,0
2,골목상권,계상초등학교,가구,70750,14,0,70750
2,골목상권,오류2동버들시장,시계및귀금속,8376955,148,4243953,4133002
2,발달상권,노원역,시계및귀금속,355442776,2411,283023677,72419099
2,골목상권,방학역 1번,가구,23967,24,23967,0
2,골목상권,남구로역 5번,시계및귀금속,126381293,366,90944652,35436641
2,골목상권,신월3동주민센터,시계및귀금속,25659908,73,21969230,3690678
2,발달상권,압구정로데오역(압구정로데오),시계및귀금속,2460261925,5277,1488069050,972192875
2,발달상권,논현역,가구,29740261033,8617,21458750230,8281510803
2,발달상권,대림3동사거리,가구,124530141,88,124530141,0
2,골목상권,성신여대운정그린캠퍼스,가구,1031845543,2634,774615694,257229849
2,전통시장,세운상가가동,가전제품,2422294945,15855,2185700646,236594299
2,전통시장,"동대문종합시장(동대문종합시장 신관, 동대문종합시장D동상가)",시계및귀금속,1435979,84,1435979,0
2,골목상권,국악고교사거리,가전제품,437871811,290,437871811,0
2,골목상권,삼성산자연공원(서울금천초등학교),가구,7701021,64,2354858,5346163
2,골목상권,화원중학교,가구,563528209,988,476994609,86533600
2,골목상권,영등포동성당,가전제품,786518216,1097,755681534,30836682
2,발달상권,"강남구청(청담역_8번, 강남세무서)",가전제품,48696219,488,48696219,0
2,발달상권,종로3가역,가전제품,9295754,170,6028623,3267131
2,발달상권,상봉역,시계및귀금속,316274916,567,199066773,117208143
2,발달상권,암사역,시계및귀금속,842729,88,633733,208996
2,전통시장,대조시장,가구,13090187,86,12183135,907052
2,발달상권,중구청(퇴계로4가),가구,3617396201,5235,3573753774,43642427
2,골목상권,수유동우체국,가구,1311620,60,864477,447143
2,발달상권,홍대입구역(홍대),시계및귀금속,75802073,772,67320495,8481578
2,발달상권,구삼강변맛길,가구,45000000,157,32133634,12866366
2,전통시장,쌍문시장(쌍문역골목시장),시계및귀금속,8767343,130,8405729,361614
2,전통시장,세종마을음식문화거리(금천교시장),시계및귀금속,14264706,433,13697059,567647
2,골목상권,응암정보도서관,가전제품,23968191,209,23968191,0
2,골목상권,새절역 2번,시계및귀금속,897311,40,897311,0
2,골목상권,연신내우체국,시계및귀금속,1884817,13,1884817,0
2,골목상권,면목동우체국,가전제품,30851312,740,22572553,8278759
2,골목상권,은평구청,가구,3744733,10,3744733,0
2,골목상권,평창동서측,시계및귀금속,24844652,53,24844652,0
2,골목상권,상봉역 4번,부동산중개업,4467692,21,4467692,0
2,발달상권,천호역,시계및귀금속,926268155,2305,752135141,174133014
2,골목상권,신월1동주민센터,가구,120165667,240,114467295,5698372
2,발달상권,경찰병원역,시계및귀금속,14844934,150,14712611,132323
2,골목상권,개화산역 1번,가전제품,293912571,2788,240658876,53253695
2,골목상권,용산구청,시계및귀금속,2731714,39,2731714,0
2,골목상권,방학1동주민센터,가전제품,6836226,27,6836226,0
2,골목상권,동대문중앙새마을금고본점,가구,3700000,100,3700000,0
2,골목상권,남영역 1번,가전제품,187779904,198,142392344,45387560
2,골목상권,마포구청역 4번,가전제품,8377204880,3331,4690909027,3686295853
2,골목상권,신월중학교,시계및귀금속,81000000,178,74439974,6560026
2,골목상권,대흥역 2번,시계및귀금속,218854868,656,218101574,753294
2,골목상권,전농1동주민센터(전농시장),가구,5454545,91,0,5454545
2,골목상권,영동초등학교,부동산중개업,443972368,696,443972368,0
2,골목상권,효창공원앞역 5번,가구,35030662,120,35030662,0
2,골목상권,금산초등학교(금천고등학교),시계및귀금속,21209303,100,21209303,0
2,골목상권,종로5가역 4번,시계및귀금속,482573,107,482573,0
2,골목상권,응암정보도서관,시계및귀금속,62766439,217,59207219,3559220
2,발달상권,강남역,시계및귀금속,536569655,3775,357657660,178911995
2,골목상권,솔숲어린이공원,가구,3986336,33,3986336,0
2,발달상권,삼호가든사거리,시계및귀금속,21765642,872,19483330,2282312
2,발달상권,합정역,시계및귀금속,274286414,624,262314510,11971904
2,골목상권,방화역 3번,시계및귀금속,33951812,858,32408137,1543675
2,발달상권,상수역(홍대),부동산중개업,546155623,38691,375485935,170669688
2,전통시장,중랑동부시장,시계및귀금속,20474115,232,14746162,5727953
2,전통시장,신영시장,시계및귀금속,29454018,432,13207224,16246794
2,전통시장,개봉중앙시장,시계및귀금속,38500836,91,23666833,14834003
2,골목상권,중앙고등학교,시계및귀금속,323595003,5354,290195578,33399425
2,골목상권,신림현대아파트,가구,62246068,238,60077215,2168853
2,골목상권,덕의초등학교,시계및귀금속,2000306,110,1723758,276548
2,골목상권,보라매역 2번,시계및귀금속,8500000,315,8333333,166667
2,골목상권,등촌1동주민센터,가구,1220305880,2051,960868779,259437101
2,골목상권,낙성대역 1번(관악구민 종합체육센터),가구,9688073,30,9688073,0
2,골목상권,대림썬프라자,시계및귀금속,6854908,20,1574449,5280459
2,골목상권,상도역 5번,시계및귀금속,21201483,128,19543829,1657654
2,골목상권,연신내역 7번,시계및귀금속,17337143,668,14583160,2753983
2,골목상권,자양한강도서관,시계및귀금속,12454718,49,9914204,2540514
2,골목상권,당곡중학교,시계및귀금속,17329607,55,6261019,11068588
2,골목상권,난곡초등학교(난곡동벽화마을),가구,24183490,68,14138040,10045450
2,골목상권,독산동정훈단지,시계및귀금속,31164765,138,30005064,1159701
2,골목상권,서초동성당,가구,399874220,104,218584094,181290126
2,골목상권,삼성산자연공원(서울금천초등학교),시계및귀금속,47160901,196,36991352,10169549
2,골목상권,방배초등학교,가구,81355025,81,81355025,0
2,골목상권,화양사거리,시계및귀금속,2603492,89,1503741,1099751
2,발달상권,한강성심병원,부동산중개업,228000000,15089,203680000,24320000
2,골목상권,마천역(마천초등학교),시계및귀금속,46630851,360,41656694,4974157
2,발달상권,가산디지털단지,부동산중개업,3501244,5,3501244,0
2,발달상권,사당역(사당),부동산중개업,56956308,3709,56956308,0
2,발달상권,오류동역,시계및귀금속,140510819,632,122565055,17945764
2,발달상권,송파사거리(송파역),시계및귀금속,54152305,230,52921884,1230421
2,발달상권,둔촌역,시계및귀금속,64144513,261,33257805,30886708
2,발달상권,수유역,시계및귀금속,238039136,1100,214798471,23240665
2,발달상권,노원역,가구,75230073,250,36203302,39026771
2,발달상권,창동역,시계및귀금속,94627095,561,91440794,3186301
2,골목상권,학동초등학교,가전제품,62792993,505,62792993,0
2,발달상권,까치산역,시계및귀금속,16613648,216,8669331,7944317
2,발달상권,대치역,가전제품,5230778408,9365,2934812028,2295966380
2,발달상권,압구정역,시계및귀금속,4411989555,29674,2056505885,2355483670
2,발달상권,포스코사거리,가전제품,3891000000,116877,3738117015,152882985
2,발달상권,양재천카페거리,가구,14974638727,88973,9759088443,5215550284
2,전통시장,본동인정시장(기능상실),가전제품,550000,19,550000,0
2,발달상권,서울세관,시계및귀금속,105492052,1875,102667741,2824311
2,전통시장,방산종합시장(방산시장),가구,1386000000,34809,1081095232,304904768
2,발달상권,독산동,시계및귀금속,200766506,1758,164076303,36690203
2,발달상권,개봉동 현대아파트,가구,4362791,83,2700775,1662016
2,골목상권,방배초등학교,시계및귀금속,16883275,163,16126307,756968
2,발달상권,미아사거리,시계및귀금속,570221498,2672,534162722,36058776
2,골목상권,가산동우체국,시계및귀금속,17191297,33,17191297,0
2,발달상권,홍제역,시계및귀금속,66011656,235,66011656,0
2,발달상권,포이사거리(삼호물산),시계및귀금속,44360999,138,44173705,187294
2,골목상권,영신초등학교,가구,293494712,513,221658877,71835835
2,전통시장,월정로시장,시계및귀금속,6899409,40,6866271,33138
2,전통시장,창동골목시장,시계및귀금속,25377458,96,21215390,4162068
2,발달상권,신사역,가구,894000000,3435,634090131,259909869
2,전통시장,"솔샘시장(미아6,7동골목시장)",시계및귀금속,148454352,669,112347330,36107022
2,전통시장,공릉동 도깨비시장,시계및귀금속,11875270,47,6652230,5223040
2,골목상권,광진정말공원,시계및귀금속,36016449,247,31144817,4871632
2,전통시장,서울중앙시장(신중앙시장),가구,9672938537,23399,8269409686,1403528851
2,전통시장,까치산시장,시계및귀금속,58208044,321,44197835,14010209
2,전통시장,화곡중앙시장,가구,63245096,164,54009676,9235420
2,전통시장,영림시장,부동산중개업,312866955,2788,312866955,0
2,골목상권,구산역 1번,가구,362629825,310,163270575,199359250
2,골목상권,호림박물관(성보고등학교),시계및귀금속,7993486,24,7993486,0
2,골목상권,방학역 1번,가전제품,1451665383,5384,1087695392,363969991
2,골목상권,도봉구 정병원,가전제품,993824019,817,350725351,643098668
2,골목상권,시립서북병원,시계및귀금속,7965823,143,7965823,0
2,골목상권,인수동 우편취급국,가구,115728713,319,26142574,89586139
2,골목상권,신방화역 2번,가전제품,7564303320,4074,4466428341,3097874979
2,골목상권,방학초등학교,시계및귀금속,39577670,424,38919296,658374
2,골목상권,홍은종합사회복지관,시계및귀금속,46480767,309,34125554,12355213
2,골목상권,신창초등학교,가구,5095115,38,3891206,1203909
2,골목상권,종암아이파크2차,시계및귀금속,12044626,120,12044626,0
2,골목상권,장스여성병원,가전제품,4000000,18,3555144,444856
2,골목상권,송중초등학교,시계및귀금속,10988349,106,7731324,3257025
2,골목상권,대림역 5번,시계및귀금속,13673914,60,482610,13191304
2,골목상권,문정역 2번,시계및귀금속,6289176,145,5343982,945194
2,골목상권,연천초등학교,시계및귀금속,4978670,109,4830865,147805
2,골목상권,망우본동주민센터,가구,37760979,11,0,37760979
2,골목상권,원신초등학교(구세군관악영문교회),가구,12885327,117,10542540,2342787
2,골목상권,대동초등학교,가구,103702870,305,25315701,78387169
2,골목상권,먹골역 5번,가전제품,3311091,148,3311091,0
2,골목상권,보문역 5번,시계및귀금속,8666667,88,7621828,1044839
2,발달상권,등나무근린공원,가구,2411888704,3531,1277322025,1134566679
2,골목상권,모래내우체국,시계및귀금속,2116403,118,2116403,0
2,발달상권,압구정역,가전제품,1253322,11,1253322,0
2,발달상권,서울대입구역,시계및귀금속,229538282,804,191050013,38488269
2,발달상권,서촌(경복궁역),가전제품,1149927517,856,1149927517,0
2,골목상권,면목동우체국,시계및귀금속,146113,6,146113,0
2,발달상권,을지로4가역,가구,2866172825,5694,1375668050,1490504775
2,골목상권,상신초등학교입구,시계및귀금속,3404391,31,3404391,0
2,발달상권,코엑스,시계및귀금속,77074529,45,48749267,28325262
2,전통시장,남부종합시장,시계및귀금속,105915,10,105915,0
2,전통시장,"남부골목시장(남부화곡시장, 남부시장)",시계및귀금속,97068486,400,83368606,13699880
2,발달상권,삼성역,시계및귀금속,1096408012,937,989656719,106751293
2,골목상권,KB국민은행 망원동지점,가구,25566719,101,7325296,18241423
2,전통시장,제일평화시장,시계및귀금속,306666667,379,168000000,138666667
2,전통시장,동남상가,시계및귀금속,195969573,660,165118405,30851168
2,전통시장,연서시장,시계및귀금속,110844921,223,89494041,21350880
2,골목상권,길상사,가구,12640431,20,259874,12380557
2,골목상권,개봉1동주민센터,가구,71546678,243,39025460,32521218
2,골목상권,구의역 4번,시계및귀금속,21859745,194,17683999,4175746
2,전통시장,삼성동 시장(삼성동시장),시계및귀금속,294650,68,294650,0
2,골목상권,뜸부기어린이공원,시계및귀금속,5765698,16,5765698,0
2,골목상권,암사동성당(효정하나플러스아파트),시계및귀금속,22062501,101,17521180,4541321
2,골목상권,길음역 8번,가구,2249550,15,749850,1499700
2,골목상권,능동우편취급국,가구,71083588,161,48757247,22326341
2,골목상권,해방촌예술마을,가전제품,22977663,362,21455483,1522180
2,골목상권,해오름공원,가구,76753923,528,73588813,3165110
2,골목상권,구반포역,가구,134000000,536,0,134000000
2,골목상권,대청초등학교,시계및귀금속,62228074,380,56552777,5675297
2,골목상권,성수119안전센터,시계및귀금속,2382322,23,920671,1461651
2,전통시장,남성역골목시장,가구,25158758,25,25158758,0
2,골목상권,자양동우체국,시계및귀금속,69823829,103,69823829,0
2,발달상권,서대문역,가전제품,32399175,30,32399175,0
2,발달상권,구산역,가전제품,40000000,72,36331,39963669
2,골목상권,오류2동버들시장,가구,7570916,140,7570916,0
2,골목상권,송파나루역 2번,시계및귀금속,8238303,133,6610695,1627608
2,골목상권,수송초등학교,가구,40879732,21,40879732,0
2,골목상권,동대문역 1번,시계및귀금속,45817,11,45817,0
2,발달상권,강남을지병원,시계및귀금속,1158346075,678,373493078,784852997
2,발달상권,방배역,시계및귀금속,78513393,632,64198674,14314719
2,발달상권,명동역(명동재미로),가전제품,73606835,9503,73606835,0
2,발달상권,장한평역(장한평),시계및귀금속,11263865,190,11120844,143021
2,발달상권,중림동,가전제품,23097188,70,23097188,0
2,발달상권,여의도역(여의도),시계및귀금속,666927257,3454,546215888,120711369
2,전통시장,로데오거리상점가,시계및귀금속,409433374,1616,261491280,147942094
2,전통시장,관악중부시장,가구,149077307,182,69975063,79102244
2,전통시장,화양제일골목시장,시계및귀금속,16157969,47,16134381,23588
2,전통시장,신월3동 골목시장,가전제품,56364220,427,49561795,6802425
2,전통시장,"황학시장(서울중앙시장, 신중앙시장)",가구,1745412750,1886,1745412750,0
2,전통시장,행당시장상점가,시계및귀금속,111704200,168,79099182,32605018
2,전통시장,석촌시장,시계및귀금속,76238839,147,44196428,32042411
2,관광특구,동대문패션타운 관광특구,시계및귀금속,1349861048,4314,539207719,810653329
2,골목상권,만리재,시계및귀금속,17876810,76,12099314,5777496
2,골목상권,중곡3동주민센터,가구,174762044,421,115179655,59582389
2,골목상권,충정로역 6번,가구,4108954535,3181,2509096176,1599858359
2,골목상권,당고개역 5번,가전제품,11824561,87,4114035,7710526
2,골목상권,계상초등학교,시계및귀금속,14639868,94,14091265,548603
2,골목상권,중화역 4번,시계및귀금속,12871324,45,12871324,0
2,골목상권,망우본동주민센터,시계및귀금속,40058654,127,34001661,6056993
2,골목상권,상월곡역 1번,가전제품,175383118,765,116152052,59231066
2,골목상권,면목5동주민센터,시계및귀금속,1798115,8,1798115,0
2,골목상권,양천향교역 5번,가전제품,15611120,88,14389380,1221740
2,골목상권,신길2동우편취급국,시계및귀금속,56000000,354,56000000,0
2,골목상권,오산중학교,시계및귀금속,3243576,120,3163629,79947
2,골목상권,황학동벼룩시장,가전제품,27555671,96,27555671,0
2,골목상권,경리단길남측,시계및귀금속,42664592,478,17394553,25270039
2,골목상권,신방화역 2번,가구,5826335,31,5826335,0
2,골목상권,화곡역 5번,부동산중개업,7389809,381,7389809,0
2,골목상권,천호공원(해공체육문화센터),가구,2722970,36,2722970,0
2,골목상권,구로4동주민센터,가전제품,112762815,2399,93586231,19176584
2,골목상권,성수동카페거리,가전제품,8712374,179,8712374,0
2,골목상권,벌말어린이공원,시계및귀금속,21395474,237,21237428,158046
2,골목상권,시흥4동주민센터(서울신흥초등학교),가구,3373874,23,3373874,0
2,골목상권,남부초등학교,시계및귀금속,5385340,9,5385340,0
2,골목상권,동대문역 1번,가전제품,28538142,138,23704821,4833321
2,발달상권,본서부병원,가전제품,2235524337,5058,1381800132,853724205
2,발달상권,본서부병원,시계및귀금속,6712208,40,5191714,1520494
2,발달상권,충정로역,시계및귀금속,3850267,24,3850267,0
2,발달상권,북촌(안국역),시계및귀금속,340435667,868,236849587,103586080
2,발달상권,성수대교남단,가구,300904735,263,222664149,78240586
2,골목상권,성수초등학교,가전제품,20321910,31,20321910,0
2,발달상권,동대문역,시계및귀금속,16405829,42,14855738,1550091
2,발달상권,여의도역(여의도),가전제품,12456582,44,12456582,0
2,전통시장,영림시장,시계및귀금속,27764185,207,27652119,112066
2,발달상권,매봉역,가전제품,3836670,45,3030743,805927
2,발달상권,신림역(신림),가구,169701496,416,116639212,53062284
2,발달상권,교육개발원입구사거리,가전제품,129398061,6304,129398061,0
2,발달상권,신논현역 1번,가구,4704473,76,4097444,607029
2,발달상권,목동신시가지,가전제품,23561386,54,8820207,14741179
2,발달상권,송파사거리(송파역),가구,169518941,628,123474496,46044445
2,발달상권,왕십리역(왕십리),가구,360000000,1100,176607423,183392577
2,발달상권,광화문역,시계및귀금속,101434473,700,101434473,0
2,발달상권,강변역(테크노마트),가전제품,11849071689,20552,8755329425,3093742264
2,발달상권,장안동사거리,가구,13533837,113,4359560,9174277
2,발달상권,상수역(홍대),가구,279553459,194,166262776,113290683
2,발달상권,신도림역,가구,2828461351,3202,1433942624,1394518727
2,발달상권,둔촌역,가구,155699613,243,75840080,79859533
2,발달상권,강남역,가구,273368339,405,273368339,0
2,전통시장,인헌시장(원당종합시장),시계및귀금속,1282801,12,1252968,29833
2,전통시장,"동원전통종합시장(동원시장, 동원전통시장 상점가)",시계및귀금속,64628607,226,56289990,8338617
2,전통시장,도화동 상점가,시계및귀금속,174066733,615,129701739,44364994
2,전통시장,창동신창시장,시계및귀금속,66591379,172,31733878,34857501
2,전통시장,창신골목시장,시계및귀금속,2381852,34,2381852,0
2,전통시장,청량리전통시장,가전제품,6902858,163,3787409,3115449
2,전통시장,동묘시장(동묘벼룩시장),가전제품,138865431,1460,138865431,0
2,전통시장,화곡본동시장,시계및귀금속,7937164,171,6315975,1621189
2,전통시장,능동로골목시장,시계및귀금속,86434011,215,46085204,40348807
2,전통시장,숭례문수입상가(남대문시장),시계및귀금속,62818705,974,62818705,0
2,전통시장,방이시장,가구,28096018,218,23256050,4839968
2,전통시장,서원동상점가,시계및귀금속,213798989,1355,155070383,58728606
2,전통시장,영림시장,가구,23212412,160,18409844,4802568
2,전통시장,남대문시장(자유상가),가구,25823781,212,25005422,818359
2,전통시장,성대전통시장(성대시장),시계및귀금속,26996410,90,26996410,0
2,관광특구,동대문패션타운 관광특구,가전제품,65772766,462,65772766,0
2,관광특구,강남 마이스 관광특구,가전제품,15623999,130,15623999,0
2,골목상권,가산초등학교(세일중학교),가구,655643634,1164,376260549,279383085
2,골목상권,남구로역 2번,가구,20388675,134,15221502,5167173
2,골목상권,독산동성당,시계및귀금속,10845800,53,6239458,4606342
2,골목상권,수락산역 4번,시계및귀금속,697498,26,653904,43594
2,골목상권,광산사거리,시계및귀금속,3288626,139,3288626,0
2,골목상권,상봉역 4번,가전제품,9852687,96,7710799,2141888
2,골목상권,남가좌파출소,시계및귀금속,22777696,145,22435866,341830
2,골목상권,홍릉시장,가전제품,511363636,1478,503409091,7954545
2,골목상권,건대입구역 6번,시계및귀금속,15541947,58,15541947,0
2,골목상권,성원중학교,가구,62293368,236,26199874,36093494
2,골목상권,KB국민은행 망원동지점,시계및귀금속,82406206,290,35008603,47397603
2,골목상권,둔촌동역 1번(한산중학교),시계및귀금속,8950533,211,8654755,295778
2,골목상권,황학동벼룩시장,시계및귀금속,3000000,118,2196898,803102
2,골목상권,화곡2동주민센터,시계및귀금속,7441948,40,5442703,1999245
2,골목상권,아현역 1번,시계및귀금속,36259093,233,25831637,10427456
2,골목상권,신당역 3번,가구,371972706,835,215830959,156141747
2,골목상권,대림성모병원,시계및귀금속,14193283,114,14193283,0
2,골목상권,신길3동주민센터,부동산중개업,65392121,6508,39386637,26005484
2,골목상권,구반포역,시계및귀금속,133493915,670,122760736,10733179
2,골목상권,석촌역 6번,시계및귀금속,63098387,92,62945161,153226
2,골목상권,아현역 2번,시계및귀금속,1429384,35,138327,1291057
2,골목상권,이수역 10번,가구,2011934066,258,2011934066,0
2,골목상권,관악구신사동주민센터,가전제품,23641909,163,10798804,12843105
2,골목상권,신풍역 6번(신길6동공영주차장),가구,40120834,202,17170711,22950123
2,골목상권,대동초등학교,시계및귀금속,8141858,51,4421745,3720113
2,발달상권,상봉역,가구,31994184,178,16112255,15881929
2,골목상권,응암3동주민센터,가구,42626160,179,26226160,16400000
2,발달상권,구산역,시계및귀금속,83039782,298,64274768,18765014
2,골목상권,까치산역 4번,시계및귀금속,108704369,287,77179470,31524899
2,발달상권,목동사거리,시계및귀금속,26924208,162,26744233,179975
2,발달상권,구의사거리,시계및귀금속,29425629,287,13712076,15713553
2,발달상권,영등포구청역,부동산중개업,58793087,235,58793087,0
2,발달상권,문래역(문래로데오거리),시계및귀금속,588145945,4270,488121549,100024396
2,발달상권,한티역,시계및귀금속,16303251,32,13293664,3009587
2,전통시장,우이골목시장(우이시장),가구,4248986,96,1964758,2284228
2,전통시장,장위전통시장,가전제품,38932337,1225,29267316,9665021
2,전통시장,성동용답상가시장,시계및귀금속,81503327,358,68830608,12672719
2,전통시장,청량리전통시장,시계및귀금속,6223751,127,4884624,1339127
2,전통시장,동묘시장(동묘벼룩시장),시계및귀금속,5697751,133,4406594,1291157
2,전통시장,"이화여대 3,5,7길 상점가",시계및귀금속,81625390,4249,81625390,0
2,전통시장,신당 미래유산 먹거리 골목형상점가,시계및귀금속,2370340,29,364667,2005673
2,전통시장,선유도역 골목형상점가,시계및귀금속,3011194565,1651,3010662141,532424
2,전통시장,전농로터리시장,가구,1924105,19,1924105,0
2,전통시장,봉천현대시장,시계및귀금속,29729347,168,20654473,9074874
2,전통시장,남구로시장,시계및귀금속,8179174,154,3581152,4598022
2,관광특구,종로?청계 관광특구,시계및귀금속,10916584905,20953,7842714921,3073869984
2,관광특구,명동 남대문 북창동 다동 무교동 관광특구,시계및귀금속,11578947917,100303,9044252905,2534695012
2,관광특구,명동 남대문 북창동 다동 무교동 관광특구,가전제품,280051582,2862,203971260,76080322
2,골목상권,신원동주민센터,시계및귀금속,66101903,315,56991435,9110468
2,골목상권,신성초등학교,가구,39814598,127,15088971,24725627
2,골목상권,서초소방서,가구,276000000,227,147569563,128430437
2,전통시장,관악신사시장,시계및귀금속,57934128,314,51387244,6546884
2,골목상권,수유시장옆,시계및귀금속,2809819,90,2809819,0
2,골목상권,쌍문역1번(쌍리단길),시계및귀금속,3322034,46,3322034,0
2,골목상권,역촌노인복지관,시계및귀금속,894813,25,872081,22732
2,골목상권,숭곡초등학교,가전제품,38400430,15,38000000,400430
2,골목상권,돌곶이역 5번,시계및귀금속,29011336,140,25521937,3489399
2,골목상권,종암경찰서,시계및귀금속,140079464,541,96841278,43238186
2,골목상권,청량초등학교,가구,59695252,288,30890688,28804564
2,골목상권,고려대역 4번,가구,3323936,64,1065364,2258572
2,골목상권,강동역 4번(강풀만화거리),시계및귀금속,6924766,103,6705165,219601
2,골목상권,성원중학교,시계및귀금속,33442604,180,26714672,6727932
2,골목상권,푸른들청소년도서관,가구,63136641,91,39180096,23956545
2,골목상권,천호지구대(천호동자전거거리),시계및귀금속,17446624,37,13081284,4365340
2,골목상권,우장산힐스테이트,부동산중개업,42798121,48,0,42798121
2,골목상권,굽은다리역 4번,시계및귀금속,14693575,148,12938344,1755231
2,골목상권,논현2동주민센터,시계및귀금속,1661928447,1819,516893861,1145034586
2,골목상권,남성역 1번,시계및귀금속,46918075,218,42953923,3964152
2,골목상권,시흥4동주민센터(서울신흥초등학교),시계및귀금속,23277131,94,23196973,80158
2,골목상권,남구로역 3번,가구,263642503,536,113147232,150495271
2,골목상권,사당5동주민센터,가전제품,91000000,152,81774193,9225807
2,발달상권,잠실새내역(신천),시계및귀금속,151048256,1180,110169536,40878720
2,발달상권,연신내역,시계및귀금속,97107894,659,56548545,40559349
2,발달상권,홍제역,가구,36463375,213,24801165,11662210
2,발달상권,본서부병원,가구,20601386,75,9677613,10923773
2,발달상권,"신촌역(신촌역, 신촌로터리)",가전제품,7770779,26,4951925,2818854
2,발달상권,홍대입구역(홍대),가구,1212000000,1315,451243942,760756058
2,발달상권,목동역 8번출구,시계및귀금속,313975475,1281,248512931,65462544
2,발달상권,코엑스,가구,8761157030,5252,3918193202,4842963828
2,발달상권,오금역,가구,12680057,5,12680057,0
2,전통시장,우림골목시장,시계및귀금속,31964788,96,27622091,4342697
2,전통시장,우림골목시장,가구,48911130,363,33143954,15767176
2,발달상권,석촌역(석촌호수),시계및귀금속,73459962,155,71346116,2113846
2,발달상권,르네상스호텔사거리,시계및귀금속,22195122,659,21097561,1097561
2,발달상권,강남구청역,가구,1705729363,976,1625235914,80493449
2,발달상권,구로구청,가전제품,108000000,350,65929081,42070919
2,전통시장,우림시장,시계및귀금속,39718644,301,36860937,2857707
2,전통시장,목사랑시장(목4동시장),시계및귀금속,54323803,369,28609015,25714788
2,전통시장,"중곡제일시장(중곡제일골목시장, 광성시장)",시계및귀금속,67560522,307,47865526,19694996
2,전통시장,답십리 건축자재시장,가구,2539603108,59604,2539603108,0
2,전통시장,"평화시장(통일상가, 동화상가)",시계및귀금속,1043194381,3935,371207719,671986662
2,전통시장,노룬산시장(노룬산골목시장),시계및귀금속,17269681,63,3741912,13527769
2,전통시장,숭례문수입상가(남대문시장),가전제품,189001065,1835,123316112,65684953
2,전통시장,중랑동부시장(중랑교종합상가),시계및귀금속,7289493,80,5399979,1889514
2,전통시장,고척골목시장상점가(그라운드 고척),시계및귀금속,24985588,45,16349165,8636423
2,전통시장,남성사계시장(남성시장),시계및귀금속,142926811,812,108882272,34044539
2,전통시장,숭인시장,시계및귀금속,46605291,180,26941799,19663492
2,전통시장,낙원시장(낙원지하시장(대일상가)),가전제품,1957418338,11485,1526566492,430851846
2,관광특구,종로?청계 관광특구,가전제품,2592291047,16590,2352429617,239861430
2,관광특구,이태원 관광특구,가구,93520285,75,92543185,977100
2,관광특구,이태원 관광특구,시계및귀금속,512394641,1895,418236121,94158520
2,발달상권,신정네거리역,시계및귀금속,107926590,495,92021619,15904971
2,발달상권,동묘앞역(동묘),가전제품,108582702,435,108582702,0
2,발달상권,용산전자상가(용산역),가구,50379593,112,5760854,44618739
2,골목상권,상계2동주민센터,가전제품,240270257,447,159182396,81087861
2,골목상권,먹골역 5번,시계및귀금속,36553349,191,31515321,5038028
2,골목상권,석계역 2번,시계및귀금속,36619877,223,16770607,19849270
2,골목상권,구산보건지소,시계및귀금속,6713450,410,6713450,0
2,전통시장,회기시장,가전제품,91669744,238,90407730,1262014
2,골목상권,구로4동주민센터,가구,118000000,90,0,118000000
1,골목상권,석촌역 6번,가구,20455275,56,852303,19602972
1,골목상권,계상초등학교,가구,7641090,28,7641090,0
1,발달상권,상계백병원,시계및귀금속,749543,10,0,749543
1,골목상권,행당역 2번,시계및귀금속,70790896,178,61094732,9696164
1,전통시장,방천골목시장,시계및귀금속,67071473,154,44658881,22412592
1,발달상권,목동사거리,시계및귀금속,36282889,162,36084917,197972
1,발달상권,가산디지털단지,가전제품,3879166828,3581,3879166828,0
1,발달상권,고덕역,가구,64256165,37,64256165,0
1,골목상권,논현초등학교,가전제품,52800000,23,52800000,0
1,전통시장,강남시장(강남구 강남시장),가구,16965900,18,16965900,0
1,골목상권,독산동성당,시계및귀금속,22123897,34,22123897,0
1,전통시장,우리시장,시계및귀금속,1058005,6,0,1058005
1,발달상권,도곡1동,가전제품,28000000,19,0,28000000
1,골목상권,영등포본동주민센터,가구,2025660458,351,2025660458,0
1,전통시장,방이시장,가구,36081967,193,32355845,3726122
1,발달상권,발산역(마곡),부동산중개업,15000000,12,15000000,0
1,골목상권,관악해태어린이공원,부동산중개업,870000000,10812,768492716,101507284
1,관광특구,명동 남대문 북창동 다동 무교동 관광특구,시계및귀금속,13304611645,25282,9388446673,3916164972
1,관광특구,이태원 관광특구,시계및귀금속,355751991,776,306259210,49492781
1,관광특구,종로?청계 관광특구,시계및귀금속,11497410826,19161,9203803559,2293607267
1,전통시장,도곡시장,시계및귀금속,527330693,580,506255684,21075009
1,전통시장,신원시장,시계및귀금속,10963544,30,9953336,1010208
1,전통시장,불광먹자골목 골목형상점가,시계및귀금속,74207174,275,43278579,30928595
1,전통시장,남구로시장,시계및귀금속,17264689,132,8046539,9218150
1,전통시장,성내전통시장,시계및귀금속,5730027,33,5674931,55096
1,전통시장,소공지하도상가,시계및귀금속,155854464,1518,150337492,5516972
1,전통시장,숭례문수입상가(남대문시장),가전제품,295108596,1627,170364111,124744485
1,전통시장,세운상가가동,시계및귀금속,231432817,1076,120366157,111066660
1,전통시장,신정1동 골목시장(신정제일시장),시계및귀금속,4518376,71,2779300,1739076
1,전통시장,고분다리전통시장,시계및귀금속,30783520,63,29011174,1772346
1,전통시장,행당시장상점가,시계및귀금속,52995467,157,36939219,16056248
1,전통시장,길동복조리시장,시계및귀금속,78865549,167,78683534,182015
1,전통시장,답십리현대시장,가구,27804306,143,22365539,5438767
1,전통시장,화곡본동시장,시계및귀금속,5695602,90,5671039,24563
1,전통시장,방신전통시장,시계및귀금속,35350970,70,35350970,0
1,전통시장,백학시장,가전제품,30950544,411,19201538,11749006
1,전통시장,은행나무시장,시계및귀금속,25985,5,25985,0
1,전통시장,독산동 맛나는거리상점가(독산동 맛나는거리),시계및귀금속,53450590,56,30250759,23199831
1,발달상권,방배동가구거리(사당동가구거리),가구,2583872184,2937,1782970737,800901447
1,발달상권,석촌고분역,가구,631894177,400,201206477,430687700
1,발달상권,남부터미널역,시계및귀금속,194235160,1419,190153470,4081690
1,발달상권,신논현역 1번,가구,17755591,61,13809904,3945687
1,발달상권,역삼역,시계및귀금속,296633,19,296633,0
1,발달상권,사당역(사당),가구,1030242986,11909,954236899,76006087
1,발달상권,삼성역,가전제품,54683998,390,39059999,15623999
1,전통시장,강북종합전통시장(강북종합골목시장),시계및귀금속,850085,48,744837,105248
1,골목상권,선정중학교,가구,9615149,28,709552,8905597
1,골목상권,돌곶이역 5번,가전제품,165093540,265,64526930,100566610
1,골목상권,숭곡초등학교,시계및귀금속,63705363,131,52108844,11596519
1,골목상권,서일대학교,시계및귀금속,17381130,232,8100999,9280131
1,골목상권,구산보건지소,시계및귀금속,8596491,164,8596491,0
1,골목상권,경동고등학교,가전제품,28505246,122,28505246,0
1,골목상권,응암정보도서관,가구,16176144,22,10784096,5392048
1,골목상권,까치산역 4번,시계및귀금속,48498765,245,31728558,16770207
1,골목상권,자양4동주민센터,가구,6611537,43,5892892,718645
1,골목상권,공항시장역 3번,시계및귀금속,16247523,96,9059273,7188250
1,골목상권,등촌3동주민센터,가구,357107299,498,159050136,198057163
1,골목상권,신월3동주민센터,가구,7643052,49,3392371,4250681
1,골목상권,중곡역 3번,시계및귀금속,2561353,39,1083352,1478001
1,골목상권,신월2동주민센터,가구,8666778,39,8666778,0
1,골목상권,굽은다리역 3번,부동산중개업,510232,99,460855,49377
1,골목상권,종로5가역 4번,시계및귀금속,2305630,80,2305630,0
1,골목상권,남산케이블카,시계및귀금속,13933397,27,13933397,0
1,골목상권,창덕궁,시계및귀금속,1978288417,4358,1092550716,885737701
1,골목상권,신방화역 2번,가전제품,3874513405,2769,2616337596,1258175809
1,골목상권,동대부고,가전제품,1078651466,3062,823426664,255224802
1,골목상권,신풍역 1번,시계및귀금속,15135135,19,3881636,11253499
1,골목상권,노량진역 6번,시계및귀금속,5471965,41,5471965,0
1,골목상권,구반포역,가전제품,46194507,714,41778856,4415651
1,골목상권,보라매역 2번,시계및귀금속,80088787,234,76410643,3678144
1,골목상권,송파책박물관,가전제품,39360295,203,39360295,0
1,골목상권,남구로역 3번,가전제품,988235,69,918885,69350
1,골목상권,상도역 5번,시계및귀금속,25038814,119,24892282,146532
1,골목상권,삼전역 1번,가구,66985360,177,58171497,8813863
1,골목상권,삼전역 4번,시계및귀금속,18106389,52,9098236,9008153
1,골목상권,경찰병원역 3번,가구,58752407,45,58752407,0
1,골목상권,남성역 1번,시계및귀금속,27096500,153,26840858,255642
1,골목상권,독산동정훈단지,가구,9839021,50,6693554,3145467
1,골목상권,석촌역 3번,가구,20000000,11,20000000,0
1,골목상권,대동초등학교,시계및귀금속,2265688,14,2192601,73087
1,발달상권,가산디지털단지,부동산중개업,14959861,10,14959861,0
1,발달상권,사당역(사당),시계및귀금속,9459828,282,7865549,1594279
1,발달상권,마들역,시계및귀금속,15115042,239,14592074,522968
1,발달상권,강남을지병원,시계및귀금속,667202906,489,65364283,601838623
1,발달상권,둔촌역,시계및귀금속,62174561,183,40828846,21345715
1,발달상권,구파발역,시계및귀금속,406809295,381,371155840,35653455
1,발달상권,오금역,가전제품,124539,10,124539,0
1,발달상권,명동역(명동재미로),가전제품,233532098,5530,233532098,0
1,발달상권,삼호가든사거리,시계및귀금속,14407091,677,11482879,2924212
1,발달상권,도곡1동,가구,991526403,250,952104143,39422260
1,발달상권,충무로역,부동산중개업,197669758,20344,186397908,11271850
1,발달상권,본서부병원,가구,38286230,58,23650497,14635733
1,발달상권,월곡역,시계및귀금속,8205236,98,7958388,246848
1,발달상권,가로수길,시계및귀금속,1061938722,5617,698244786,363693936
1,발달상권,홍제역,시계및귀금속,29504613,341,22528412,6976201
1,발달상권,삼청동,시계및귀금속,13452012,282,7216879,6235133
1,발달상권,명동(명동거리),시계및귀금속,1229905096,3017,1130385592,99519504
1,발달상권,홍대입구역(홍대),시계및귀금속,93832503,780,70619219,23213284
1,발달상권,을지로4가역,가구,3737775647,3539,3065439153,672336494
1,발달상권,장안동사거리,가구,26136024,135,23717997,2418027
1,발달상권,등촌역,가구,3104479366,3432,1738940749,1365538617
1,발달상권,구의사거리,가구,150529951,529,106842449,43687502
1,발달상권,"신촌역(신촌역, 신촌로터리)",시계및귀금속,31762283,727,21093802,10668481
1,발달상권,화곡역,시계및귀금속,2921352,57,2740290,181062
1,발달상권,신논현역,가구,254745277,1029,254745277,0
1,발달상권,한티역,부동산중개업,39875001,4889,35648149,4226852
1,발달상권,뱅뱅사거리,부동산중개업,17577347,47,17577347,0
1,발달상권,"총신대입구역(이수, 총신대)",시계및귀금속,438038514,1132,402457041,35581473
1,발달상권,신용산역(용산역),가구,8598000000,10181,3767066605,4830933395
1,전통시장,방학동도깨비시장,시계및귀금속,100797508,478,69114136,31683372
1,발달상권,구로디지털단지,가전제품,64000000,105,57699774,6300226
1,발달상권,구로디지털단지역,시계및귀금속,164008555,724,141555962,22452593
1,발달상권,"총신대입구역(이수, 총신대)",가구,2078459179,1792,2065704727,12754452
1,발달상권,대림3동사거리,시계및귀금속,31944391,68,29188625,2755766
1,발달상권,구로전화국,가구,48719416,579,46734245,1985171
1,발달상권,개봉동 현대아파트,가구,137116280,167,137116280,0
1,발달상권,내방역,가전제품,2154728,5,2154728,0
1,발달상권,목동신시가지,가전제품,2429640,14,2429640,0
1,발달상권,송파사거리(송파역),가구,56715627,377,41148219,15567408
1,전통시장,독산동 우시장,시계및귀금속,126761,16,42254,84507
1,전통시장,중랑동부시장,가전제품,78240569,441,55701068,22539501
1,전통시장,밤나무골시장,시계및귀금속,2965536,36,2965536,0
1,전통시장,서울중앙시장(신중앙시장),가구,6326678733,17842,5247050284,1079628449
1,전통시장,중부시장(신중부시장),가구,5244466809,146455,5143089923,101376886
1,전통시장,송화벽화시장(송화골목시장),시계및귀금속,17587972,159,14302618,3285354
1,전통시장,왕십리도선동상점가,시계및귀금속,25679232,114,20998012,4681220
1,전통시장,답십리 건축자재시장,가구,2084934573,51038,2084934573,0
1,전통시장,목2동시장,시계및귀금속,41102048,163,37674982,3427066
1,전통시장,능동로골목시장,시계및귀금속,89318558,213,60757727,28560831
1,전통시장,세운상가가동,가전제품,2295789043,14048,1926688690,369100353
1,전통시장,세종마을음식문화거리(금천교시장),시계및귀금속,2176470,176,2176470,0
1,전통시장,숭례문수입상가(남대문시장),시계및귀금속,180664649,486,78888607,101776042
1,전통시장,신노량진시장(기능상실),시계및귀금속,3066800,36,2425976,640824
1,전통시장,고척골목시장상점가(그라운드 고척),시계및귀금속,34447167,49,16142875,18304292
1,전통시장,봉천현대시장,시계및귀금속,23981419,115,23981419,0
1,관광특구,잠실 관광특구,시계및귀금속,2074357207,2432,1843385249,230971958
1,관광특구,잠실 관광특구,가구,103300730,84,93630164,9670566
1,관광특구,강남 마이스 관광특구,시계및귀금속,1592007498,2186,1041930662,550076836
1,골목상권,언주역 3번,가구,59265574,77,59265574,0
1,골목상권,충정로역 6번,가구,2867436117,3298,1524084905,1343351212
1,전통시장,상도도깨비 골목형상점가,시계및귀금속,687285,14,687285,0
1,골목상권,시흥초등학교(시흥1동우체국),가구,15416058,47,3153284,12262774
1,골목상권,암사역 2번(서울강동초등학교),시계및귀금속,9369672,33,8966676,402996
1,골목상권,연신내역 7번,시계및귀금속,9375131,641,5598629,3776502
1,골목상권,원신초등학교(구세군관악영문교회),가전제품,20349627,186,7659575,12690052
1,골목상권,신성초등학교,가구,41526372,139,17307939,24218433
1,골목상권,상계2동주민센터,가전제품,537637091,1027,423711997,113925094
1,골목상권,하나고등학교,가구,2000000,3,662534,1337466
1,골목상권,당고개역 5번,가전제품,15342105,157,12131579,3210526
1,골목상권,종암동주민센터,시계및귀금속,26393751,384,704688,25689063
1,골목상권,장스여성병원,시계및귀금속,17901264,128,13608395,4292869
1,골목상권,외대앞역 1번,가구,2113134,45,1848992,264142
1,골목상권,은평세무서,가구,221502564,473,86167170,135335394
1,골목상권,공릉동 국수거리,가구,143342477,125,85438459,57904018
1,골목상권,보문역 5번,시계및귀금속,4289341,32,4261845,27496
1,골목상권,경신고등학교,시계및귀금속,12986574,104,12986574,0
1,골목상권,면목5동주민센터,시계및귀금속,402682,8,0,402682
1,골목상권,강동역 4번(강풀만화거리),시계및귀금속,7671411,132,7085807,585604
1,골목상권,장훈고등학교,가구,1206687,44,1206687,0
1,골목상권,개화산역 1번,가전제품,215842297,2450,138508989,77333308
1,골목상권,청담초등학교,시계및귀금속,2807855918,3333,1005262704,1802593214
1,골목상권,달마을공원,시계및귀금속,17618597,134,15179358,2439239
1,골목상권,성수119안전센터,시계및귀금속,3091307,10,336012,2755295
1,골목상권,화곡초등학교,시계및귀금속,9798558,107,8648119,1150439
1,골목상권,성동구보건소,가전제품,44037600,638,44037600,0
1,골목상권,동묘앞역 2번,시계및귀금속,3420726,28,3420726,0
1,골목상권,남천초등학교,시계및귀금속,28916110,82,28916110,0
1,골목상권,남구로역 2번,시계및귀금속,608084,108,608084,0
1,골목상권,당곡중학교,시계및귀금속,10509568,67,1341647,9167921
1,골목상권,문정역 2번,시계및귀금속,43606169,164,43606169,0
1,골목상권,은천초등학교(은천교앞),시계및귀금속,6423120,876,6423120,0
1,골목상권,신대방역 2번,가구,120936451,112,47849856,73086595
1,골목상권,신월7동주민센터,시계및귀금속,17818978,55,16591142,1227836
1,골목상권,거여역 1번(거여공원),가전제품,193088529,522,93440721,99647808
1,골목상권,방이역 1번,가구,39646151,50,33017416,6628735
1,골목상권,화곡역 5번,부동산중개업,8359900,428,8359900,0
1,발달상권,양재화물트럭터미널앞,가전제품,178824909,372,95218458,83606451
1,발달상권,등나무근린공원,가구,1844051936,3591,747787925,1096264011
1,발달상권,송파사거리(송파역),시계및귀금속,65111580,158,12194830,52916750
1,발달상권,상봉역,가구,22864953,125,17839689,5025264
1,골목상권,까치산역 1번,시계및귀금속,8093429,34,8093429,0
1,발달상권,연희동,시계및귀금속,7681876,72,6165717,1516159
1,골목상권,이수역 10번,가구,1115109890,272,0,1115109890
1,발달상권,용산전자상가(용산역),가전제품,1.85E+11,493764,1.10E+11,75331899608
1,발달상권,구로전화국,가전제품,689756642,2530,366921963,322834679
1,발달상권,언주역(차병원),가구,2917086,27,2917086,0
1,발달상권,공릉역,시계및귀금속,32354217,91,28786885,3567332
1,발달상권,대학로(혜화역),시계및귀금속,66016357,181,62779674,3236683
1,발달상권,상봉역,가전제품,1021990064,2946,643330483,378659581
1,발달상권,성신여대,가구,84123827,547,81041275,3082552
1,발달상권,충정로역,시계및귀금속,13716578,24,13716578,0
1,발달상권,이태원(이태원역),시계및귀금속,355751991,776,306259210,49492781
1,발달상권,동묘앞역(동묘),가전제품,58531565,227,58531565,0
1,발달상권,광화문역,시계및귀금속,75184696,451,75184696,0
1,발달상권,종로구청,시계및귀금속,2885808216,1967,2660905372,224902844
1,발달상권,북촌(안국역),시계및귀금속,1193989474,766,509667538,684321936
1,발달상권,중구청(퇴계로4가),가구,1822131411,4746,1691635131,130496280
1,발달상권,구의사거리,시계및귀금속,39674728,128,33239094,6435634
1,발달상권,용산전자상가(용산역),시계및귀금속,174000000,797,115623439,58376561
1,발달상권,영등포구청역,부동산중개업,116000000,464,58000000,58000000
1,골목상권,새절역 2번,시계및귀금속,2135990,30,2135990,0
1,발달상권,서울역,시계및귀금속,44993535,3433,44065439,928096
1,발달상권,을지로3가역,부동산중개업,54985,550,54985,0
1,발달상권,등촌역,시계및귀금속,121172749,125,121172749,0
1,발달상권,구의역,시계및귀금속,15316742,194,8352940,6963802
1,발달상권,둔촌역,가구,193943520,324,90850081,103093439
1,발달상권,목동역 8번출구,가구,30495868,108,24132232,6363636
1,발달상권,어린이대공원역,가전제품,53987425,225,53987425,0
1,발달상권,포이사거리(삼호물산),시계및귀금속,9772310,105,5112009,4660301
1,발달상권,신도림역,시계및귀금속,456659014,1698,290514852,166144162
1,발달상권,학동사거리,가구,56241938,628,54984839,1257099
1,전통시장,삼양골목시장(삼양시장),시계및귀금속,5073293,25,2956827,2116466
1,전통시장,유진상가,시계및귀금속,8952953,128,7595252,1357701
1,전통시장,"수유전통시장(수유시장, 수유골목시장)",가전제품,167748923,1653,128859576,38889347
1,발달상권,신림역(신림),가구,57586026,391,39246527,18339499
1,발달상권,교육개발원입구사거리,가전제품,145992146,4245,131034841,14957305
1,발달상권,서울대입구역,가전제품,2495579065,7978,1709837081,785741984
1,발달상권,역삼역,가전제품,5247000,74,1929200,3317800
1,발달상권,잠실역,시계및귀금속,559326076,2217,327308916,232017160
1,발달상권,대치사거리,부동산중개업,195000000,30834,153402532,41597468
1,발달상권,가산디지털단지,가구,322084916,973,322084916,0
1,발달상권,교대입구교차로,부동산중개업,40000000,9,40000000,0
1,전통시장,대명여울빛거리시장(대명시장),시계및귀금속,21000000,114,17000184,3999816
1,전통시장,뚝도시장,시계및귀금속,110886360,394,91177272,19709088
1,전통시장,쌍문시장(쌍문역골목시장),시계및귀금속,6007346,56,3891520,2115826
1,전통시장,충신시장,가전제품,2327228,145,2327228,0
1,전통시장,창신골목시장,시계및귀금속,2041588,11,0,2041588
1,전통시장,신아타운,시계및귀금속,19226622,62,18914906,311716
1,전통시장,사가정시장,시계및귀금속,19861400,130,12183083,7678317
1,전통시장,왕십리도선동상점가,가구,24184008,84,7389558,16794450
1,전통시장,행당시장상점가,가구,8060167,33,6661295,1398872
1,전통시장,암사종합시장,시계및귀금속,8231391,90,3891854,4339537
1,전통시장,신영시장,시계및귀금속,90210624,358,76861956,13348668
1,전통시장,제일평화시장,시계및귀금속,132266666,321,116266666,16000000
1,전통시장,"평화시장(통일상가, 동화상가)",시계및귀금속,625517975,1380,411430834,214087141
1,전통시장,까치산시장,시계및귀금속,62472072,407,46922753,15549319
1,전통시장,목동깨비시장(목3동시장),시계및귀금속,1770503,26,1770503,0
1,전통시장,전농로터리시장,가구,3569215,39,3569215,0
1,전통시장,중랑동부시장(중랑교종합상가),시계및귀금속,5813103,59,4211234,1601869
1,전통시장,신영시장,가구,20655219,200,13935416,6719803
1,전통시장,대림중앙 골목형상점가,부동산중개업,15991719,940,15991719,0
1,전통시장,남성사계시장(남성시장),시계및귀금속,129614538,526,84979370,44635168
1,전통시장,화곡중앙시장,가구,29635179,82,20458210,9176969
1,전통시장,남구로시장,가구,17974192,84,11154944,6819248
1,전통시장,문정동 로데오거리 상점가(문정동 로데오거리),시계및귀금속,9332025,102,9170664,161361
1,전통시장,성대전통시장(성대시장),시계및귀금속,10141191,70,4188752,5952439
1,관광특구,동대문패션타운 관광특구,시계및귀금속,757784641,1701,527697500,230087141
1,관광특구,종로?청계 관광특구,가전제품,2394671026,14541,2023324648,371346378
1,관광특구,명동 남대문 북창동 다동 무교동 관광특구,가전제품,511865784,2168,275156881,236708903
1,골목상권,신원동주민센터,시계및귀금속,294072212,332,265240777,28831435
1,골목상권,암사역 1번,시계및귀금속,37825907,182,35437331,2388576
1,골목상권,공릉역 2번,시계및귀금속,4215493,57,4196730,18763
1,골목상권,먹골역 5번,가구,185517654,698,107317824,78199830
1,골목상권,신림현대아파트,가구,59968773,303,21688527,38280246
1,골목상권,서강대역 1번,가전제품,289859,9,289859,0
1,골목상권,영신초등학교,가구,290902142,382,249543260,41358882
1,골목상권,방학역 1번,가구,23727273,48,20851240,2876033
1,골목상권,신림역 8번,가전제품,4025617048,1818,2503660503,1521956545
1,골목상권,중곡3동주민센터,가구,160749329,518,118111796,42637533
1,골목상권,가산초등학교(세일중학교),가구,695073637,1117,323139985,371933652
1,골목상권,포이초등학교(개포목련어린이공원),가구,1007493642,795,277246039,730247603
1,골목상권,금천금빛공원(은행나무사거리서측),가구,55787140,177,23592018,32195122
1,골목상권,개봉1동주민센터,가전제품,13224377,122,10786704,2437673
1,골목상권,서초소방서,가구,276000000,129,131744661,144255339
1,골목상권,구립대학경로당(관악산샘말공원),부동산중개업,182096,19,182096,0
1,골목상권,방학역 1번,시계및귀금속,37819399,69,30747585,7071814
1,골목상권,방학초등학교,시계및귀금속,11982403,338,11606189,376214
1,골목상권,수락산역 4번,가구,13995842,17,2968815,11027027
1,골목상권,광산사거리,시계및귀금속,9675801,82,5546791,4129010
1,골목상권,종암아이파크2차,시계및귀금속,24328450,150,17319036,7009414
1,골목상권,광운대역 1번,시계및귀금속,16047017,98,11139038,4907979
1,골목상권,서울여자간호대학교,시계및귀금속,93750,10,93750,0
1,골목상권,중화역 4번,가구,18122969,125,4994389,13128580
1,골목상권,연천초등학교,시계및귀금속,22964115,93,8168130,14795985
1,골목상권,상월곡역 1번,가전제품,159858951,1067,61539708,98319243
1,골목상권,종암경찰서,시계및귀금속,58616481,228,24575256,34041225
1,골목상권,남가좌파출소,시계및귀금속,7415076,144,5370671,2044405
1,골목상권,내를건너서숲으로도서관,가전제품,690183,17,690183,0
1,골목상권,장안1동주민센터,가전제품,29304762,232,27432458,1872304
1,골목상권,면목동우체국,시계및귀금속,11841029,11,11841029,0
1,골목상권,이태원엔틱가구거리,가구,254111334,358,221360218,32751116
1,골목상권,황학코아루아파트,시계및귀금속,5738393,24,2544735,3193658
1,골목상권,신설동역 12번,가구,40000000,287,13205742,26794258
1,골목상권,구의역 4번,시계및귀금속,43951835,213,29888539,14063296
1,골목상권,길동주민센터(강동도서관),시계및귀금속,60562186,195,53341230,7220956
1,골목상권,경리단길남측,시계및귀금속,2465369,273,1438132,1027237
1,골목상권,암사동성당(효정하나플러스아파트),시계및귀금속,10184007,58,5305305,4878702
1,골목상권,자양4동주민센터,시계및귀금속,1577143,34,0,1577143
1,골목상권,동대문역 1번,가전제품,11128953,77,7142233,3986720
1,골목상권,명지대학교,시계및귀금속,3991116,87,1245974,2745142
1,골목상권,논현2동주민센터,시계및귀금속,2155185629,2425,567698789,1587486840
1,골목상권,구로4동주민센터,시계및귀금속,312012,6,312012,0
1,골목상권,푸른동산공원,시계및귀금속,39000000,26,39000000,0
1,골목상권,서울대입구역 8번,시계및귀금속,91324,9,91324,0
1,골목상권,양재역 8번(양재동우체국),부동산중개업,82000000,25,82000000,0
1,골목상권,관악구신사동주민센터,가전제품,12326936,142,8673001,3653935
1,골목상권,대동초등학교,가구,82474282,306,51241418,31232864
1,골목상권,사당역 10번,시계및귀금속,72681302,255,72575322,105980
1,골목상권,시흥4동주민센터(서울신흥초등학교),시계및귀금속,14871625,152,14646737,224888
1,골목상권,서강대학교,가전제품,450853921,1607,251263031,199590890
1,골목상권,성자초등학교,시계및귀금속,283844810,768,187821532,96023278
1,발달상권,포이사거리(삼호물산),가전제품,389985107,422,389985107,0
1,발달상권,강남역,시계및귀금속,563250480,4007,365275836,197974644
1,골목상권,서울지방병무청,가구,2157879,65,2157879,0
1,골목상권,신월3동주민센터,가전제품,19832335,413,11005443,8826892
1,발달상권,대치역,가전제품,4479584815,9377,2579532043,1900052772
1,발달상권,서울대입구역,가구,43302089,374,17964858,25337231
1,발달상권,천호역,시계및귀금속,695549399,1615,603305307,92244092
1,발달상권,선정릉역,시계및귀금속,34000000,10,34000000,0
1,발달상권,장안동사거리,시계및귀금속,18741316,1213,13197705,5543611
1,발달상권,명동역(명동재미로),시계및귀금속,350996864,448,82376815,268620049
1,발달상권,압구정역,시계및귀금속,3317462591,28269,1092884128,2224578463
1,발달상권,잠실새내역(신천),시계및귀금속,153694580,1207,114035004,39659576
1,발달상권,홍제역,가구,69686096,214,38717757,30968339
1,발달상권,종로4가,시계및귀금속,16170698151,18888,12252425446,3918272705
1,발달상권,아차산역,가구,1800111166,1340,1645835022,154276144
1,발달상권,구삼강변맛길,가구,45000000,148,29851239,15148761
1,발달상권,성수대교남단,가구,443881592,263,252916284,190965308
1,발달상권,용산전자상가(용산역),가구,23043414,93,10035035,13008379
1,발달상권,상수역(홍대),부동산중개업,492063935,33641,383123151,108940784
1,발달상권,목동신시가지,시계및귀금속,306886926,3028,162187233,144699693
1,발달상권,종각역,시계및귀금속,1125855816,5332,649158367,476697449
1,발달상권,목동사거리,가구,118530105,520,87524812,31005293
1,발달상권,문래역(문래로데오거리),시계및귀금속,453896935,2930,425750462,28146473
1,발달상권,코엑스,가구,8755158344,4229,5553649689,3201508655
1,발달상권,강남구청역,가구,1081878769,2124,707611254,374267515
1,발달상권,신논현역,시계및귀금속,6890003,230,6890003,0
1,발달상권,학동사거리,시계및귀금속,400451923,398,96734628,303717295
1,전통시장,청량리수산시장,가구,261907374,480,136368312,125539062
1,전통시장,영림시장,시계및귀금속,34517652,125,13926568,20591084
1,전통시장,공릉동 도깨비시장,시계및귀금속,53097448,113,45967353,7130095
1,전통시장,창동신창시장,시계및귀금속,55823474,258,32412930,23410544
1,전통시장,우이골목시장(우이시장),가구,3162779,48,3162779,0
1,발달상권,문정역,가구,3122372338,919,2667942804,454429534
1,발달상권,서울세관,가구,688596331,289,429509083,259087248
1,발달상권,구로구청,가전제품,108000000,375,62904886,45095114
1,전통시장,남대문시장(자유상가),시계및귀금속,2665649553,14636,2279915768,385733785
1,전통시장,우림시장,시계및귀금속,23058333,151,21866658,1191675
1,전통시장,"솔샘시장(미아6,7동골목시장)",시계및귀금속,153267135,661,124891491,28375644
1,전통시장,청량리전통시장,시계및귀금속,2588979,52,2474197,114782
1,전통시장,동묘시장(동묘벼룩시장),시계및귀금속,3023806,66,2124161,899645
1,전통시장,뚝섬역상점가,시계및귀금속,86323091,81,82219623,4103468
1,전통시장,고덕 골목형상점가,시계및귀금속,6563549,150,6563549,0
1,전통시장,대림상가(청계상가),가전제품,1225155104,7288,1143467975,81687129
1,전통시장,신당 미래유산 먹거리 골목형상점가,시계및귀금속,2060372,44,2060372,0
1,전통시장,금남시장,시계및귀금속,93016145,259,91305812,1710333
1,전통시장,홍대 걷고싶은 거리,시계및귀금속,115470347,1081,59832662,55637685
1,전통시장,마천중앙시장,가전제품,17093341,321,15806874,1286467
1,전통시장,고척근린시장,시계및귀금속,38295214,71,28603689,9691525
1,전통시장,석촌시장,시계및귀금속,52178571,107,30334821,21843750
1,전통시장,남대문시장(자유상가),가구,126087945,152,126087945,0
1,전통시장,숭인시장,시계및귀금속,6574604,140,6524339,50265
1,전통시장,신림중앙시장(조원동 펭귄시장),시계및귀금속,44838421,54,18770198,26068223
1,관광특구,동대문패션타운 관광특구,가전제품,9033328,210,9033328,0
1,관광특구,강남 마이스 관광특구,가구,8755158344,4229,5553649689,3201508655
1,골목상권,방배초등학교,시계및귀금속,7042683,124,3104530,3938153
1,골목상권,영신여고,시계및귀금속,117916,24,117916,0
1,골목상권,창2동주민센터,시계및귀금속,2007251,12,778675,1228576
1,골목상권,가산동우체국,시계및귀금속,29389651,104,27667076,1722575
1,골목상권,문성초등학교,가구,96259345,335,53421090,42838255
1,골목상권,아차산역 1번,가전제품,56492877,257,40907894,15584983
1,골목상권,등촌1동주민센터,가구,1191330723,3024,827968713,363362010
1,골목상권,남구로역 5번,시계및귀금속,130601846,252,57671707,72930139
1,골목상권,면목동우체국,가전제품,29881144,609,19477258,10403886
1,골목상권,푸른들청소년도서관,시계및귀금속,10138910,36,10138910,0
1,골목상권,삼성산자연공원(서울금천초등학교),가구,10692326,75,9610364,1081962
1,골목상권,구산역 1번,가구,205867382,207,116341888,89525494
1,골목상권,금천구립가산도서관,시계및귀금속,381779,19,381779,0
1,골목상권,도봉구보건소,시계및귀금속,25449442,379,23857532,1591910
1,골목상권,상계제일중학교,가전제품,9117990,49,4858348,4259642
1,골목상권,중화역 4번,시계및귀금속,46526527,108,41254475,5272052
1,골목상권,수락산역 4번,가전제품,117000000,333,65925778,51074222
1,골목상권,갈현건영아파트,시계및귀금속,6175289,340,6033719,141570
1,골목상권,홍릉시장,가전제품,1859090909,2272,1463636364,395454545
1,골목상권,상봉역 4번,부동산중개업,1025641,21,1025641,0
1,골목상권,KB국민은행 망원동지점,가구,34701793,86,24791099,9910694
1,골목상권,신월1동주민센터,가구,15395601,60,8797487,6598114
1,골목상권,공항시장역 1번,시계및귀금속,54992398,199,38549730,16442668
1,골목상권,황학동벼룩시장,가전제품,106664735,519,82443804,24220931
1,골목상권,둔촌동역 1번(한산중학교),시계및귀금속,2002142,176,1827046,175096
1,골목상권,푸른들청소년도서관,가구,12535402,28,2437439,10097963
1,골목상권,화곡2동주민센터,가구,19367707,40,17714373,1653334
1,골목상권,해방촌예술마을,가전제품,14448625,387,4034984,10413641
1,골목상권,태릉시장 특화거리,가전제품,32355991,258,11157814,21198177
1,골목상권,관악구 중앙길,가구,2132701,21,2132701,0
1,골목상권,구반포역,가구,38012658,292,38012658,0
1,골목상권,영등포역 2번,부동산중개업,12448598,1496,8074767,4373831
1,골목상권,자양동우체국,시계및귀금속,9795776,56,7934568,1861208
1,골목상권,구로디지털단지역 4번,가구,16039953,106,11508298,4531655
1,골목상권,한성백제역 3번,가구,26912971,13,26912971,0
1,골목상권,봉천역 4번(봉천110안전센터),가구,115089102,381,115089102,0
1,골목상권,방배역 3번,가구,78612928,77,78612928,0
1,골목상권,원신초등학교(구세군관악영문교회),가구,32213317,87,27820592,4392725
1,골목상권,삼성산자연공원(서울금천초등학교),시계및귀금속,56568502,196,43172963,13395539
1,골목상권,동대문역 1번,시계및귀금속,3161382,28,3161382,0
1,골목상권,서문여고,가구,22087890,488,22087890,0
1,골목상권,신정네거리역 2번,가구,65338471,165,56857693,8480778
1,골목상권,노량진초등학교,가구,28658309,84,27077888,1580421
1,골목상권,NH농협은행 상도동지점,시계및귀금속,29483613,188,21181874,8301739
1,골목상권,벌말어린이공원,시계및귀금속,15923133,238,15528018,395115
1,골목상권,오류2동버들시장,가구,26666449,168,12449951,14216498
1,발달상권,포스코사거리,시계및귀금속,100330162,134,0,100330162
1,발달상권,군자역,가구,4961562094,5685,2832806320,2128755774
1,골목상권,강동구립성내도서관,시계및귀금속,201888,5,201888,0
1,발달상권,양재역,시계및귀금속,167302447,831,153266656,14035791
1,발달상권,오금역,시계및귀금속,9109199,41,9109199,0
1,발달상권,합정역,시계및귀금속,325507518,1168,261054489,64453029
1,발달상권,연신내역,시계및귀금속,61035243,487,38336996,22698247
1,발달상권,한성대입구역,가구,175714940,205,156327767,19387173
1,발달상권,본서부병원,시계및귀금속,10907889,79,9872190,1035699
1,발달상권,한성대입구역,시계및귀금속,10177286,297,9751988,425298
1,발달상권,대학로(혜화역),가전제품,465790132,1529,309489823,156300309
1,발달상권,신당역,가구,145286289,182,145286289,0
1,발달상권,홍대입구역(홍대),가구,1212000000,1513,503543336,708456664
1,발달상권,도산공원교차로,가구,1197518286,979,488149816,709368470
1,발달상권,신정네거리역,시계및귀금속,80251322,371,66773056,13478266
1,발달상권,"강남구청(청담역_8번, 강남세무서)",가전제품,81637122,751,81637122,0
1,발달상권,상봉역,시계및귀금속,607794852,774,534102733,73692119
1,발달상권,서촌(경복궁역),가전제품,45449567,321,39567858,5881709
1,발달상권,을지로3가역,가구,1174172421,9150,1016843349,157329072
1,발달상권,성수역,가전제품,42000000,74,26243021,15756979
1,발달상권,논현역,시계및귀금속,22907359,98,14132962,8774397
1,발달상권,선릉역,시계및귀금속,9688909,19,9688909,0
1,발달상권,신대방삼거리역,시계및귀금속,10066555,299,4775374,5291181
1,발달상권,강남역,가구,177064412,386,176616587,447825
1,발달상권,목동신시가지,가구,1335432366,728,1091054002,244378364
1,전통시장,영등포역지하도상점가,시계및귀금속,1276888470,2173,1053417469,223471001
1,전통시장,비단길현대시장(현대시장),시계및귀금속,75188844,225,63171691,12017153
1,전통시장,영천시장,시계및귀금속,12672759,156,8444525,4228234
1,전통시장,"남부골목시장(남부화곡시장, 남부시장)",시계및귀금속,69058718,247,64440819,4617899
1,발달상권,"총신대입구역(이수, 총신대)",가전제품,518628816,1779,326903973,191724843
1,골목상권,체부동홍종문가옥,시계및귀금속,134783841,385,124090909,10692932
1,발달상권,석촌역(석촌호수),시계및귀금속,11087813,91,10937222,150591
1,발달상권,대림3동사거리,가구,173762988,88,173762988,0
1,발달상권,가산디지털단지,시계및귀금속,57626057,707,57626057,0
1,발달상권,서래마을카페거리(서래마을),시계및귀금속,12284184,117,7260156,5024028
1,전통시장,관악중부시장,시계및귀금속,30539505,179,28314317,2225188
1,전통시장,제일시장,시계및귀금속,441093613,2423,262912374,178181239
1,전통시장,남대문시장(자유상가),가전제품,215258553,458,103294135,111964418
1,전통시장,신월3동 골목시장,가전제품,29554139,284,18409173,11144966
1,전통시장,광장시장(광장전통시장),시계및귀금속,469971913,920,422797138,47174775
1,전통시장,망원월드컵시장,가구,39126582,105,32731046,6395536
1,전통시장,"이화여대 3,5,7길 상점가",시계및귀금속,84000000,2250,49530121,34469879
1,전통시장,성동용답상가시장,시계및귀금속,58136401,329,40181224,17955177
1,전통시장,목동깨비시장(목3동시장),가구,74709961,326,46264562,28445399
1,전통시장,종로신진시장,시계및귀금속,80511952,548,68749596,11762356
1,전통시장,망원시장,시계및귀금속,93634585,138,79631723,14002862
1,전통시장,"동원전통종합시장(동원시장, 동원전통시장 상점가)",가구,159129047,627,121984867,37144180
1,전통시장,화곡본동시장,가구,3048791,20,3048791,0
1,전통시장,강남터미널지하도상점가2구역,가구,142925743,1997,79405654,63520089
1,전통시장,공덕시장,시계및귀금속,6213922,163,5969440,244482
1,전통시장,관악신사시장,가구,14443390,171,0,14443390
1,전통시장,낙원시장(낙원지하시장(대일상가)),가전제품,1625482062,10542,1332681277,292800785
1,전통시장,월정로시장,가구,22137931,78,14405173,7732758
1,전통시장,도곡시장,가구,35283162,136,25598916,9684246
1,전통시장,석촌시장,가구,1523237,16,481022,1042215
1,관광특구,강남 마이스 관광특구,가전제품,1246364675,5307,771093180,475271495
1,골목상권,만리재,시계및귀금속,7038039,66,3409199,3628840
1,골목상권,시흥동 은행나무사거리,시계및귀금속,6345078,67,6345078,0
1,골목상권,신월3동주민센터,시계및귀금속,24735235,135,24735235,0
1,골목상권,청량초등학교,가구,41257122,433,16335958,24921164
1,골목상권,영서중학교,시계및귀금속,12604654,36,9464547,3140107
1,골목상권,포이초등학교(개포목련어린이공원),가전제품,200238216,861,200238216,0
1,골목상권,수락산디자인거리,시계및귀금속,2311929,60,2293653,18276
1,골목상권,방학역 1번,가전제품,2104741440,8118,1733375231,371366209
1,골목상권,상계역,시계및귀금속,1153846,38,1153846,0
1,골목상권,홍은종합사회복지관,시계및귀금속,58773059,264,50479050,8294009
1,골목상권,수유동우체국,가구,18839635,179,15560585,3279050
1,골목상권,창2동주민센터,가구,5219542,21,5219542,0
1,골목상권,먹골역 5번,시계및귀금속,48546333,189,37787197,10759136
1,골목상권,상봉역 4번,가구,173097931,298,109625846,63472085
1,골목상권,모래내우체국,시계및귀금속,6907702,106,5144033,1763669
1,골목상권,상월곡역 1번,시계및귀금속,315434,15,315434,0
1,골목상권,신내1동주민센터,시계및귀금속,13295404,180,13235515,59889
1,골목상권,러스크서울병원,시계및귀금속,14630878,60,14630878,0
1,골목상권,등촌3동주민센터,시계및귀금속,47317104,425,40112291,7204813
1,골목상권,충정로역 7번,가구,78619881,101,66124072,12495809
1,골목상권,공항시장역 1번,가구,64640445,187,51105623,13534822
1,골목상권,뜸부기어린이공원,시계및귀금속,74368375,104,73722678,645697
1,골목상권,화곡역 4번,시계및귀금속,51671245,110,36402914,15268331
1,골목상권,목동보건지소,시계및귀금속,11911833,105,9992266,1919567
1,골목상권,대흥역 2번,시계및귀금속,232635531,478,223068553,9566978
1,골목상권,해오름공원,시계및귀금속,10590054,144,4160219,6429835
1,골목상권,응암정보도서관,시계및귀금속,83666927,174,66917659,16749268
1,골목상권,강서고등학교,시계및귀금속,16534318,59,16534318,0
1,골목상권,신당역 3번,가구,377049156,983,199619076,177430080
1,골목상권,모래내우체국,가전제품,4462361535,2607,3290830820,1171530715
1,골목상권,창신역 1번,시계및귀금속,12742043,22,12742043,0
1,골목상권,아현역 2번,가전제품,5592506,443,4232453,1360053
1,골목상권,대청초등학교,시계및귀금속,67792794,249,41978248,25814546
1,골목상권,장승배기역 5번,가구,18000000,84,6655860,11344140
1,골목상권,신대방역 3번,부동산중개업,475095,70,475095,0
1,골목상권,덕의초등학교,시계및귀금속,986322,46,811181,175141
1,골목상권,마천1치안센터,가전제품,10812848,58,10812848,0
1,골목상권,평창동서측,시계및귀금속,23095958,13,23095958,0
1,발달상권,압구정역,가전제품,3946270,6,3946270,0
1,발달상권,장한평역(장한평),시계및귀금속,22010400,149,20939970,1070430
1,발달상권,장지역(가든파이브),가구,3079160921,2849,1332158170,1747002751
1,골목상권,사근동살곶이상점가,시계및귀금속,6753768,387,6226130,527638
1,발달상권,금호역,시계및귀금속,37111924,281,19767835,17344089
1,발달상권,청담사거리(청담동명품거리),시계및귀금속,3360046528,3611,2220045272,1140001256
1,발달상권,서교동(홍대),시계및귀금속,12008314,131,7349519,4658795
1,발달상권,학동역,가구,11698027616,18568,7557271842,4140755774
1,골목상권,쌍문2동우체국,가구,50038760,420,28228069,21810691
1,골목상권,솔숲어린이공원,가구,1074039,24,929457,144582
1,발달상권,미아사거리,시계및귀금속,277149031,1849,123139097,154009934
1,발달상권,석촌역(석촌호수),가구,699291696,638,467774018,231517678
1,발달상권,공릉역,가전제품,1287983644,3461,809750358,478233286
1,발달상권,성북구청,가전제품,51729865,748,34493136,17236729
1,발달상권,성신여대,시계및귀금속,119225747,1095,61605939,57619808
1,골목상권,시립서북병원,시계및귀금속,432082,99,432082,0
1,발달상권,본서부병원,가전제품,1810812509,5304,1340272508,470540001
1,골목상권,4.19민주묘지역 2번,시계및귀금속,59059569,350,55911280,3148289
1,골목상권,은평구청,가구,9756015,20,0,9756015
1,골목상권,길음역 8번,가구,5998800,15,0,5998800
1,발달상권,압구정로데오역(압구정로데오),시계및귀금속,2680380771,3064,1510226201,1170154570
1,발달상권,강변역(테크노마트),가전제품,6438282112,19335,4492551398,1945730714
1,발달상권,강변역(테크노마트),가구,1401266661,1827,616952415,784314246
1,발달상권,강변역(테크노마트),시계및귀금속,333172692,3276,266297851,66874841
1,발달상권,노량진역(노량진),가구,832632794,960,387034642,445598152
1,골목상권,서울역 15번,가구,13599552,108,4088912,9510640
1,발달상권,신용산역(용산역),시계및귀금속,73606695,272,40994930,32611765
1,골목상권,쌍문역1번(쌍리단길),시계및귀금속,180791,51,158192,22599
1,골목상권,강동역 4번(강풀만화거리),가전제품,14208654,70,14208654,0
1,발달상권,서대문역,시계및귀금속,12248029,233,10340888,1907141
1,발달상권,청량리역(청량리),시계및귀금속,21226049,180,15853017,5373032
1,전통시장,"수유전통시장(수유시장, 수유골목시장)",시계및귀금속,182763979,335,148539071,34224908
1,골목상권,해방촌 남동측,시계및귀금속,32258696,84,32079348,179348
1,발달상권,왕십리역(왕십리),시계및귀금속,504649530,5028,420910986,83738544
1,골목상권,먹골역 5번,가전제품,1094607,111,1094607,0
1,발달상권,건대입구역(건대),시계및귀금속,500129341,3718,301816161,198313180
1,골목상권,숭곡초등학교,가전제품,1225806,8,1225806,0
1,발달상권,인사동,가전제품,28816468,167,28566253,250215
1,발달상권,신당역,가전제품,3987342,80,3987342,0
1,발달상권,암사역,시계및귀금속,3276532,80,2534930,741602
1,발달상권,신정네거리역,가구,1637390279,1318,761235238,876155041
1,발달상권,서울남부지방법원,가전제품,272664074,352,170015191,102648883
1,발달상권,어린이대공원역,시계및귀금속,10226788,75,7923132,2303656
1,발달상권,코엑스,가전제품,1191680677,4917,732033181,459647496
1,발달상권,상수역(홍대),가구,145537928,78,99177679,46360249
1,발달상권,고속터미널(고속터미널역),시계및귀금속,8957173195,19103,7728131077,1229042118
1,발달상권,목동역 8번출구,시계및귀금속,426284460,1224,307338261,118946199
1,발달상권,개나리아파트,가구,1043726939,411,495793840,547933099
1,발달상권,여의도역(여의도),가전제품,3044036,6,3044036,0
1,발달상권,방이동먹자골목,시계및귀금속,1524000000,277,1524000000,0
1,발달상권,경찰병원역,시계및귀금속,3895245,116,2257754,1637491
1,발달상권,역삼역,가구,333996821,4137,147366951,186629870
1,발달상권,영등포역(영등포),가전제품,472434076,1792,293193283,179240793
1,발달상권,오금역,가구,9129641,15,7100832,2028809
1,발달상권,뱅뱅사거리,시계및귀금속,62010957,142,24275102,37735855
1,발달상권,신용산역(용산역),가전제품,6365389347,18112,3369713653,2995675694
1,발달상권,한티역,시계및귀금속,3049187,16,3049187,0
1,발달상권,대치사거리,가구,2130121895,5039,1097286702,1032835193
1,발달상권,학동역,시계및귀금속,15000000,177,10028015,4971985
1,발달상권,당산2동(영등포우체국),가전제품,2976190,74,2976190,0
1,골목상권,아차산역 5번,가구,1935247152,2373,823801330,1111445822
1,골목상권,방학중학교,시계및귀금속,25178948,30,25178948,0
1,전통시장,종로4가지하쇼핑센터,시계및귀금속,21602,4,21602,0
1,전통시장,우림골목시장,가전제품,15875455,206,10034407,5841048
1,골목상권,은평세무서,가전제품,260744723,5472,236144347,24600376
1,전통시장,창동골목시장,시계및귀금속,57837861,130,45425983,12411878
1,전통시장,대조시장,시계및귀금속,16567216,33,16567216,0
1,발달상권,길동역,가전제품,13281318,132,13281318,0
1,발달상권,선릉역,가구,544659157,22741,473863226,70795931
1,골목상권,보문역 4번,가구,91828543,291,57015610,34812933
1,발달상권,석촌고분역,시계및귀금속,2457480,49,2249220,208260
1,발달상권,선정릉역,가구,13614825,45,13614825,0
1,발달상권,삼성중앙역,가구,2882937592,938,942052962,1940884630
1,발달상권,보라매역,시계및귀금속,399495,57,399495,0
1,골목상권,송파나루역 2번,시계및귀금속,19992559,127,19959138,33421
1,발달상권,신정네거리역,가전제품,6213570,321,2356871,3856699
1,전통시장,난곡 골목형상점가,시계및귀금속,10301385,10,10301385,0
1,전통시장,관악중부시장,가구,72956608,98,17037407,55919201
1,골목상권,남구로역 2번,가전제품,3425915,34,3425915,0
1,전통시장,목사랑시장(목4동시장),시계및귀금속,7630240,193,5577968,2052272
1,전통시장,"중곡제일시장(중곡제일골목시장, 광성시장)",시계및귀금속,52514019,198,41201523,11312496
1,전통시장,"황학시장(서울중앙시장, 신중앙시장)",가구,93365318,236,93365318,0
1,전통시장,백학시장,가구,150668,22,150668,0
1,전통시장,영등포유통상가,가전제품,284782253,958,189487266,95294987
1,전통시장,노룬산시장(노룬산골목시장),시계및귀금속,86757260,178,72927295,13829965
1,발달상권,명일역,시계및귀금속,94236055,417,56087442,38148613
1,전통시장,수일시장,시계및귀금속,20900123,133,18406574,2493549
1,전통시장,방이시장,시계및귀금속,33633476,252,25506985,8126491
1,발달상권,동대문역,시계및귀금속,3267760,8,3267760,0
1,골목상권,장훈고등학교,시계및귀금속,5414938,31,4823652,591286
1,전통시장,사당시장,가전제품,1443464712,876,1137387122,306077590
1,골목상권,성원중학교,가전제품,147651119,217,144862326,2788793
1,전통시장,서서울 골목형상점가,가전제품,72695966,344,36470974,36224992
1,골목상권,석촌고분역 1번,가구,959807951,441,959807951,0
1,골목상권,동교초등학교,시계및귀금속,28437752,211,28437752,0
1,골목상권,KB국민은행 망원동지점,시계및귀금속,43651867,184,20799970,22851897
1,골목상권,성원중학교,시계및귀금속,56595730,240,43602636,12993094
1,발달상권,화곡역,가전제품,253943669,2295,225137404,28806265
1,골목상권,석촌역 6번,시계및귀금속,14035485,123,10266130,3769355
1,골목상권,광진초등학교,가전제품,27393,5,27393,0
1,발달상권,논현역 5번,가구,2076000000,1749,646163115,1429836885
1,골목상권,금호삼성래미안아파트,시계및귀금속,17572586,15,17572586,0
1,골목상권,마천역(마천초등학교),가구,95920937,474,88174711,7746226
1,골목상권,시흥초등학교(시흥1동우체국),시계및귀금속,9941402,35,9941402,0
1,골목상권,구로4동주민센터,가전제품,139442140,2827,122579684,16862456
1,골목상권,성원중학교,가구,78870969,535,60601424,18269545
1,골목상권,우장산역 4번,시계및귀금속,8510320,255,7742028,768292
1,발달상권,포스코사거리,가전제품,3891000000,115028,3741529545,149470455
1,골목상권,성신여대운정그린캠퍼스,가구,1097562860,3316,691605298,405957562
1,골목상권,개봉1동주민센터,가구,50975117,182,18605161,32369956
1,골목상권,방배아이파크아파트,가구,2686147285,5150,2019601036,666546249
1,골목상권,암사역 2번(서울강동초등학교),가전제품,2340262816,1392,1607758343,732504473
1,골목상권,묘곡초등학교(고덕아이파크아파트),시계및귀금속,3501856,109,3138969,362887
1,발달상권,은마아파트,가구,9665587,90,7497605,2167982
1,골목상권,신월1파출소,시계및귀금속,5746269,22,5746269,0
1,골목상권,상계2동주민센터,가구,46261459,115,40225694,6035765
1,골목상권,굽은다리역 4번,시계및귀금속,5850768,103,5184224,666544
1,골목상권,금동어린이공원,시계및귀금속,10610738,21,10610738,0
1,골목상권,신방화역 2번,시계및귀금속,213406820,456,182720289,30686531
1,골목상권,신월2동주민센터,시계및귀금속,28096071,832,20072399,8023672
1,전통시장,"동원전통종합시장(동원시장, 동원전통시장 상점가)",시계및귀금속,63828923,211,53041040,10787883
1,골목상권,경춘선숲길 우측,시계및귀금속,29655386,109,24811984,4843402
1,골목상권,해오름공원,가구,34288695,264,19518181,14770514
1,골목상권,그라운드 고척,시계및귀금속,14840734,28,2823359,12017375
1,전통시장,월정로시장,시계및귀금속,11335313,27,11335313,0
1,골목상권,먹골역 1번,가구,543642151,581,252354351,291287800
1,골목상권,망우본동주민센터,시계및귀금속,95733577,236,73262528,22471049
1,골목상권,석관중앙교회,가구,27079866,203,12652624,14427242
1,골목상권,역촌노인복지관,시계및귀금속,3263071,12,3263071,0
1,골목상권,대림역 5번,시계및귀금속,26684239,70,18439674,8244565
1,골목상권,망우역 1번,가전제품,4915419496,9687,2459907807,2455511689
1,골목상권,장안중학교,시계및귀금속,77870967,146,34957600,42913367
1,골목상권,응암동우체국,가구,85457783,231,63912997,21544786
1,전통시장,남부종합시장,시계및귀금속,3707016,30,3707016,0
1,골목상권,자양한강도서관,시계및귀금속,2218303,25,2168732,49571
1,골목상권,망리단길,가전제품,481492655,378,333945004,147547651
1,골목상권,인수동 우편취급국,가구,18172277,192,18172277,0
1,골목상권,고려대역 6번,가전제품,370000000,114,370000000,0
1,골목상권,마천역(마천초등학교),시계및귀금속,82642670,425,43547287,39095383
1,골목상권,대림성모병원,시계및귀금속,48421642,136,48421642,0
1,골목상권,장안제일시장,시계및귀금속,1138462,6,1138462,0
1,골목상권,면목역 3번,시계및귀금속,10768877,24,8112627,2656250
1,골목상권,고려대역 4번,가구,2450338,64,1917656,532682
1,전통시장,아현가구거리상점가,가구,4475985331,5523,2436759757,2039225574
1,전통시장,장미원골목시장,시계및귀금속,12924518,82,12924518,0
1,골목상권,화원중학교,시계및귀금속,7384123,29,7078135,305988
1,골목상권,구반포역,시계및귀금속,760982398,2146,746224277,14758121
1,골목상권,장안근린공원,시계및귀금속,37960340,85,36062323,1898017
1,전통시장,도화동 상점가,시계및귀금속,115187857,523,100709243,14478614
1,골목상권,신림역 8번,가구,1683900052,5265,834188562,849711490
1,골목상권,영신초등학교,가전제품,263163606,1165,137404007,125759599
1,골목상권,오산중학교,시계및귀금속,4288600,57,3232154,1056446
1,골목상권,도봉역 2번,가전제품,38742858,600,38742858,0
1,골목상권,공항시장역 3번,가구,12790764,75,12790764,0
1,골목상권,구로4동주민센터,가구,12955169,108,0,12955169
1,골목상권,계상초등학교,시계및귀금속,26058653,16,26058653,0
1,골목상권,상계초등학교,시계및귀금속,16287464,24,14321314,1966150
1,골목상권,도봉구 정병원,가전제품,405245157,102,405245157,0
1,골목상권,석계역 2번,시계및귀금속,2025436,70,2025436,0
1,전통시장,인헌시장(원당종합시장),시계및귀금속,190929,24,101431,89498
1,전통시장,창동역상점가,시계및귀금속,45567479,247,37398373,8169106
1,골목상권,수락산역 4번,시계및귀금속,87187,9,87187,0
1,골목상권,신창초등학교,가구,2988273,34,1762866,1225407
1,골목상권,상신초등학교입구,시계및귀금속,11000000,16,46283,10953717
1,골목상권,화양사거리,시계및귀금속,2177058,89,987532,1189526
1,발달상권,삼각지역,부동산중개업,7700000,18,7700000,0
1,발달상권,매봉역,가전제품,1475642,17,1475642,0
1,전통시장,전곡시장,시계및귀금속,3863051,16,3863051,0
1,골목상권,미아사거리역 3번,가구,1308596,5,1308596,0
1,골목상권,양천향교역 5번,가구,6674188,133,6674188,0
1,골목상권,염곡동 구룡사(포이동성당),가구,73000000,211,73000000,0
1,골목상권,홍대부속여중고앞,시계및귀금속,11687389,24,1119005,10568384
1,전통시장,풍납시장,시계및귀금속,12763270,103,12736891,26379
1,전통시장,충신시장,시계및귀금속,23000000,7,23000000,0
1,골목상권,샤로수길,가전제품,1671429,37,1671429,0
1,골목상권,돌곶이역 5번,시계및귀금속,60105348,170,41032405,19072943
1,골목상권,송중초등학교,시계및귀금속,11391364,99,5527073,5864291
1,골목상권,남부초등학교,시계및귀금속,4057714,9,4057714,0
1,골목상권,서초동성당,가구,378119405,208,378119405,0
1,전통시장,우림골목시장,가구,73868613,364,69282114,4586499
1,골목상권,신성초등학교,부동산중개업,10000000,67,0,10000000
1,발달상권,신사역,가구,894000000,3336,767683482,126316518
1,발달상권,독산동,시계및귀금속,133685239,1029,98602689,35082550
1,골목상권,아현역 2번,시계및귀금속,5251324,30,742870,4508454
1,골목상권,문성초등학교,가전제품,361993314,3019,286760214,75233100
1,골목상권,황학동벼룩시장,시계및귀금속,2428571,113,375000,2053571
1,골목상권,성수동카페거리,가전제품,6693111,144,6693111,0
1,발달상권,삼성역,시계및귀금속,1537593178,2141,987516342,550076836
1,골목상권,곰달래도서관,시계및귀금속,34967277,78,33132556,1834721
1,발달상권,왕십리역(왕십리),가구,360000000,1324,192565069,167434931
1,골목상권,천호지구대(천호동자전거거리),시계및귀금속,23414431,37,17888683,5525748
1,발달상권,강동구청역,가전제품,5366487579,2495,3309331469,2057156110
1,골목상권,신정역 5번,시계및귀금속,22680317,131,17840857,4839460
1,발달상권,르네상스호텔사거리,시계및귀금속,26204003,400,25960101,243902
1,골목상권,난곡초등학교(난곡동벽화마을),가구,15130184,43,7193038,7937146
1,골목상권,독산동정훈단지,시계및귀금속,25811341,75,10391211,15420130
1,발달상권,남부터미널역,가전제품,2961209298,11715,2615633239,345576059
1,골목상권,신방화역 2번,가구,15112444,47,8973014,6139430
1,골목상권,금산초등학교(금천고등학교),시계및귀금속,2936877,14,2936877,0
1,골목상권,아현역 1번,시계및귀금속,31787969,132,24394725,7393244
1,골목상권,마포구청역 4번,가전제품,7292452745,2945,5158676347,2133776398
1,발달상권,압구정역,부동산중개업,90000000,210,90000000,0
1,골목상권,방화역 3번,시계및귀금속,52602290,750,51203053,1399237
1,골목상권,효창공원앞역 5번,가구,6013848,60,6013848,0
1,골목상권,두산초등학교,가구,66828194,180,40638767,26189427
1,골목상권,관악구신사동주민센터,가구,3451327,46,1610619,1840708
1,골목상권,응암3동주민센터,가구,29409282,132,20344303,9064979
1,골목상권,언주역 6번,가구,935323907,160,914904304,20419603
1,골목상권,신길3동주민센터,부동산중개업,84631572,4841,47149008,37482564
1,골목상권,학동근린공원,시계및귀금속,103429950,90,103429950,0
1,골목상권,오류2동버들시장,시계및귀금속,54117355,112,30290185,23827170
1,골목상권,서초중학교,시계및귀금속,43064644,428,42391233,673411
1,골목상권,신월시영아파트중문,가구,102425556,157,78788889,23636667
1,발달상권,상계백병원,가구,19356554,33,19356554,0
1,골목상권,삼선중학교,가구,140686625,308,133282066,7404559
1,골목상권,대림썬프라자,시계및귀금속,101734,20,87201,14533
1,전통시장,화양제일골목시장,시계및귀금속,9473052,14,9449464,23588
1,골목상권,금천구청역 1번 출입구,시계및귀금속,60412001,229,52500141,7911860
1,골목상권,구로초등학교,시계및귀금속,34238431,62,27250996,6987435
1,골목상권,영신초등학교,시계및귀금속,42103794,145,34321702,7782092
1,골목상권,화곡역 4번,가구,70611557,702,70611557,0
1,발달상권,등나무근린공원,시계및귀금속,91128032,504,58429529,32698503
1,골목상권,남구로역 2번,가구,44282675,103,12349544,31933131
1,전통시장,정릉시장,시계및귀금속,5062157,205,4853700,208457
1,전통시장,중랑동부시장,시계및귀금속,45689161,127,39800677,5888484
1,골목상권,삼전역 4번,가전제품,1834521,15,0,1834521
1,발달상권,논현역,가전제품,6958742752,3290,4367257434,2591485318
1,골목상권,난우초등학교,가구,40412749,148,27806688,12606061
1,골목상권,선일여고,시계및귀금속,4648240,12,4648240,0
1,전통시장,장위전통시장,시계및귀금속,86552084,86,85206262,1345822
1,발달상권,"강남구청(청담역_8번, 강남세무서)",가구,1828099084,843,1553412893,274686191
1,골목상권,남구로역 3번,가구,146870778,378,101800990,45069788
1,발달상권,노원역,가전제품,2199157818,1369,1456122206,743035612
1,발달상권,노원역,가구,97968521,389,68855293,29113228
1,전통시장,수유프라자,가구,44240220,187,32032397,12207823
1,발달상권,창동역,시계및귀금속,96137207,400,86700701,9436506
1,발달상권,독산동,가구,127136693,33,127136693,0
1,발달상권,구산역,시계및귀금속,40371860,231,37003149,3368711
1,전통시장,"황학시장(서울중앙시장, 신중앙시장)",시계및귀금속,104075215,350,89759555,14315660
1,발달상권,사당역(사당),부동산중개업,43057927,4027,38101619,4956308
1,발달상권,양재화물트럭터미널앞,가구,294599740,152,142744204,151855536
1,골목상권,학동초등학교,가전제품,60605240,403,60605240,0
1,골목상권,사당5동주민센터,가전제품,46337423,152,34613497,11723926
1,전통시장,연희사러가,시계및귀금속,18260151,63,3119297,15140854
1,발달상권,오류동역,시계및귀금속,88223608,414,68147098,20076510
1,전통시장,동묘시장(동묘벼룩시장),가전제품,43029903,883,43029903,0
1,발달상권,방배역,시계및귀금속,48514891,622,38883871,9631020
1,전통시장,전곡시장,가구,20046866,77,18659006,1387860
1,발달상권,신도림역,가구,2382146631,2609,1109460857,1272685774
1,골목상권,신대방역 4번,시계및귀금속,8376932,45,1867830,6509102
1,발달상권,청담사거리(청담동명품거리),가구,7116877947,2057,5108124388,2008753559
1,발달상권,구로전화국,시계및귀금속,165793784,616,165410550,383234
1,발달상권,강서구청,시계및귀금속,1024011,20,1024011,0
1,발달상권,장지역(가든파이브),가전제품,242842888,1410,189200105,53642783
1,골목상권,석촌고분역 3번,시계및귀금속,24135924,100,3694824,20441100
1,전통시장,전곡시장,가전제품,169130824,318,119983396,49147428
1,전통시장,황학동주방가구거리상점가,가전제품,264033328,381,264033328,0
1,발달상권,까치산역,시계및귀금속,42405681,108,36466726,5938955
1,발달상권,을지로4가역,시계및귀금속,6210866,66,326888,5883978
1,골목상권,개봉1동주민센터,시계및귀금속,5663631,53,5262902,400729
1,골목상권,영등포동성당,가전제품,58991913,610,58991913,0
1,발달상권,미아사거리역,시계및귀금속,234225662,7012,159401836,74823826
1,발달상권,연신내역,가전제품,70717108,857,55321475,15395633
1,발달상권,미아사거리역,가전제품,354179044,7234,248446245,105732799
1,발달상권,인사동,시계및귀금속,205258819,5526,100898778,104360041
1,발달상권,롯데백화점(시청광장 지하쇼핑센터),시계및귀금속,8803917834,5401,5748919214,3054998620
1,전통시장,인현시장,시계및귀금속,3642213,91,3642213,0
1,발달상권,강남을지병원,가구,637488488,360,266841558,370646930
1,골목상권,중앙고등학교,시계및귀금속,343279728,3634,298112324,45167404
1,골목상권,인헌고등학교(인헌중학교),시계및귀금속,9138397,288,9035487,102910
1,발달상권,종로3가역,가전제품,18193822,136,16897520,1296302
1,발달상권,신설동역,가전제품,70179084,221,4847574,65331510
1,발달상권,종로4가,가전제품,69701561,234,68751838,949723
1,발달상권,사가정역,시계및귀금속,19754741,99,14977690,4777051
1,발달상권,약수역,시계및귀금속,92428117,404,68562386,23865731
1,전통시장,선유도역 골목형상점가,시계및귀금속,928888264,2283,928038921,849343
1,발달상권,명일역,가구,29295153,115,24329086,4966067
1,발달상권,충무로역,시계및귀금속,30308944,157,30308944,0
1,발달상권,동대문역사문화공원역,시계및귀금속,44564627,149,44564627,0
1,발달상권,발산역(마곡),가구,173552719,111,81478434,92074285
1,발달상권,논현역,가구,21906245288,8703,13281151988,8625093300
1,발달상권,천호역,가구,3626257305,6739,1671604818,1954652487
1,발달상권,"신촌역(신촌역, 신촌로터리)",가전제품,6126810,9,6126810,0
1,발달상권,등촌역,부동산중개업,1497934,239,1497934,0
1,발달상권,한남오거리,시계및귀금속,16183841,139,16183841,0
1,발달상권,굽은다리역,시계및귀금속,15520018,74,13658762,1861256
1,발달상권,마포역,시계및귀금속,20961933,352,20961933,0
1,발달상권,여의도역(여의도),시계및귀금속,254356493,2219,209705894,44650599
1,발달상권,목동사거리,가전제품,3328084887,9084,2058835528,1269249359
1,골목상권,수유시장옆,시계및귀금속,5106304,36,4205721,900583
1,발달상권,영등포역(영등포),시계및귀금속,8959507742,80990,5004206920,3955300822
1,발달상권,영등포역(영등포),부동산중개업,73614175,1226,30672573,42941602
1,발달상권,신설동역,시계및귀금속,23161498,234,21218155,1943343
1,발달상권,월드컵경기장역(월드컵경기장),시계및귀금속,42372725,1283,30950700,11422025
1,발달상권,길동역,가구,12910148,423,11250819,1659329
1,전통시장,도림시장,시계및귀금속,39401044,197,25975320,13425724
1,전통시장,엔터식스 강남점,시계및귀금속,6746520,18,6746520,0
1,전통시장,개봉중앙시장,시계및귀금속,6006538,54,3898887,2107651
1,발달상권,아차산역,가전제품,478515387,1636,313044955,165470432
1,발달상권,합정역,가전제품,8911123,64,3564449,5346674
1,발달상권,오목교역,시계및귀금속,907027872,1601,846642896,60384976
1,발달상권,노량진역(노량진),시계및귀금속,63629308,666,44459315,19169993
1,발달상권,코엑스,시계및귀금속,54414320,45,54414320,0
1,전통시장,동남상가,시계및귀금속,192258987,607,130081612,62177375
1,전통시장,용산용문시장,시계및귀금속,12827073,44,12827073,0
1,전통시장,미성동 도깨비시장 골목형상점가,시계및귀금속,4703269,43,4458943,244326
1,발달상권,대치역,시계및귀금속,30067919,926,27791907,2276012
1,발달상권,신도림역,가전제품,1257196259,5639,898465884,358730375
1,전통시장,연서시장,시계및귀금속,8032564,164,6146915,1885649
1,전통시장,관악신사시장,시계및귀금속,32277975,137,892447,31385528
1,골목상권,연신내우체국,시계및귀금속,3392670,13,3392670,0
1,발달상권,구역삼세무서,가구,306584790,295,95879946,210704844
1,발달상권,서래마을카페거리(서래마을),가구,498506452,2470,256905386,241601066
1,발달상권,서울세관,시계및귀금속,110126964,1676,109536674,590290
1,골목상권,성수초등학교,가전제품,13036929,62,13036929,0
1,관광특구,동대문패션타운 관광특구,가구,2821601659,7284,2473503884,348097775
1,전통시장,로데오거리상점가,시계및귀금속,275847386,1265,117103518,158743868
1,전통시장,방산종합시장(방산시장),가구,1386000000,40005,1178027999,207972001
1,관광특구,이태원 관광특구,가구,184108372,78,153995860,30112512
1,전통시장,우림골목시장,시계및귀금속,13999561,39,8926480,5073081
1,전통시장,공릉동 도깨비시장,가구,27180748,122,10892659,16288089
1,골목상권,화원중학교,가구,477849930,730,327729656,150120274
1,전통시장,장위전통시장,가전제품,36391299,590,32307487,4083812
1,발달상권,강남구청역,시계및귀금속,220872036,131,174305612,46566424
1,골목상권,뜸부기어린이공원,가구,114648663,529,74172095,40476568
1,발달상권,성수대교남단,시계및귀금속,71737555,743,71737555,0
1,골목상권,암사역 3번(천호동자전거거리),가구,25040650,23,0,25040650
1,전통시장,남문시장,시계및귀금속,8573904,33,8110092,463812
1,전통시장,황학동주방가구거리상점가,가구,3819791278,6035,3546297359,273493919
1,골목상권,신월중학교,시계및귀금속,74410584,252,64484464,9926120
1,골목상권,석촌중학교(방이육교),가전제품,323124769,6398,287821482,35303287
1,골목상권,신림현대아파트,가전제품,2699059,64,1456635,1242424
1,전통시장,대조시장,가구,11992177,38,11992177,0
1,전통시장,회기시장,가전제품,17338970,164,4974895,12364075
1,전통시장,회기시장,시계및귀금속,33243997,199,32692086,551911
1,전통시장,강북북부골목시장,시계및귀금속,6787810,35,5784515,1003295
1,전통시장,제일시장,가구,966771088,1754,579361355,387409733
1,전통시장,수유프라자,시계및귀금속,45595914,280,20810443,24785471
1,골목상권,홍릉시장,시계및귀금속,12872858,35,12655411,217447
1,전통시장,연희사러가,가전제품,84249867,3563,55985156,28264711
1,전통시장,청량리전통시장,가전제품,15923407,244,15007098,916309
1,골목상권,화곡2동주민센터,시계및귀금속,14164621,17,8501038,5663583
1,전통시장,고척근린시장,가구,387382187,969,255770999,131611188
1,골목상권,국악고교사거리,가전제품,94727235,193,57996266,36730969
1,전통시장,신곡종합시장(신월6동 골목시장),시계및귀금속,33682739,230,17473894,16208845
1,골목상권,헌인가구단지,가구,153187944,340,66676783,86511161
1,골목상권,남구로역 5번,가전제품,2108342,115,1021228,1087114
1,발달상권,서울대입구역,시계및귀금속,330660663,741,302297882,28362781
1,골목상권,광진정말공원,시계및귀금속,16303195,139,15877095,426100
1,골목상권,경의선책거리,가구,9436219,8,9436219,0
1,발달상권,종로3가역,시계및귀금속,1.94E+11,311932,1.52E+11,41786288341
1,전통시장,서원동상점가,시계및귀금속,181351360,1364,104012031,77339329
1,골목상권,연신내역 3번,가구,147389399,500,126500218,20889181
1,전통시장,새마을시장,시계및귀금속,8553308,146,4104673,4448635
1,전통시장,까치산시장,가전제품,8292928,214,7489044,803884
1,발달상권,신림역(신림),시계및귀금속,151593589,1713,108075074,43518515
1,관광특구,명동 남대문 북창동 다동 무교동 관광특구,가구,126087945,152,126087945,0
1,골목상권,양지어린이공원,시계및귀금속,10616678,84,7492292,3124386
1,골목상권,능동우편취급국,가구,77613577,262,44279541,33334036
1,골목상권,문정초등학교,시계및귀금속,6648643,26,6648643,0
1,골목상권,문성초등학교,시계및귀금속,46658671,67,42188535,4470136
1,발달상권,미아사거리,가전제품,157361043,116,157361043,0
1,골목상권,우리은행응암동지점,시계및귀금속,29075576,395,28109221,966355
1,골목상권,봉천역 6번,시계및귀금속,54000000,44,54000000,0
1,골목상권,호림박물관(성보고등학교),시계및귀금속,55204241,37,52265098,2939143
1,골목상권,용두동신동아아파트,시계및귀금속,36701763,96,33132534,3569229
1,골목상권,수락산디자인거리,가구,28746056,127,24700315,4045741
1,골목상권,신대방삼거리역 3번,가구,25902402,65,18190551,7711851
1,골목상권,성자초등학교,가구,5101596,42,3833091,1268505
1,골목상권,신풍역 6번(신길6동공영주차장),가구,49753184,185,45648965,4104219
1,전통시장,영동전통시장,가구,12709760,45,12709760,0
1,발달상권,한강성심병원,부동산중개업,228000000,14576,155504143,72495857
1,발달상권,노원역,시계및귀금속,141283229,2143,113999372,27283857
1,골목상권,방학1동주민센터,가전제품,774628,21,774628,0
1,골목상권,쌍문2동우체국,가전제품,24905660,38,24905660,0
1,골목상권,도봉산입구,시계및귀금속,56651649,142,55860867,790782
1,발달상권,수유역,시계및귀금속,199508557,758,164138110,35370447
1,발달상권,양재천카페거리,가구,14790136564,87696,9890663397,4899473167
1,골목상권,전농1동주민센터(전농시장),가구,18181818,91,18181818,0
